cell_TCAACACTAAAC	./macosko/1m_reads/kmer_7/reads_split/cell_TCAACACTAAAC.umi.txt	./macosko/1m_reads/kmer_7/reads_split/cell_TCAACACTAAAC_reads.fastq.gz
cell_GCTAGTTGTGCT	./macosko/1m_reads/kmer_7/reads_split/cell_GCTAGTTGTGCT.umi.txt	./macosko/1m_reads/kmer_7/reads_split/cell_GCTAGTTGTGCT_reads.fastq.gz
cell_GTCATATCCAAT	./macosko/1m_reads/kmer_7/reads_split/cell_GTCATATCCAAT.umi.txt	./macosko/1m_reads/kmer_7/reads_split/cell_GTCATATCCAAT_reads.fastq.gz
cell_TCCAAAATAGAA	./macosko/1m_reads/kmer_7/reads_split/cell_TCCAAAATAGAA.umi.txt	./macosko/1m_reads/kmer_7/reads_split/cell_TCCAAAATAGAA_reads.fastq.gz
cell_AGACGATGAAGG	./macosko/1m_reads/kmer_7/reads_split/cell_AGACGATGAAGG.umi.txt	./macosko/1m_reads/kmer_7/reads_split/cell_AGACGATGAAGG_reads.fastq.gz
cell_AGGAGATTGTGC	./macosko/1m_reads/kmer_7/reads_split/cell_AGGAGATTGTGC.umi.txt	./macosko/1m_reads/kmer_7/reads_split/cell_AGGAGATTGTGC_reads.fastq.gz
cell_ACTAAGTAAGAT	./macosko/1m_reads/kmer_7/reads_split/cell_ACTAAGTAAGAT.umi.txt	./macosko/1m_reads/kmer_7/reads_split/cell_ACTAAGTAAGAT_reads.fastq.gz
cell_GGCCCACTTTAA	./macosko/1m_reads/kmer_7/reads_split/cell_GGCCCACTTTAA.umi.txt	./macosko/1m_reads/kmer_7/reads_split/cell_GGCCCACTTTAA_reads.fastq.gz
cell_CCCGCCTTCTAC	./macosko/1m_reads/kmer_7/reads_split/cell_CCCGCCTTCTAC.umi.txt	./macosko/1m_reads/kmer_7/reads_split/cell_CCCGCCTTCTAC_reads.fastq.gz
cell_TCGTCAATTGTC	./macosko/1m_reads/kmer_7/reads_split/cell_TCGTCAATTGTC.umi.txt	./macosko/1m_reads/kmer_7/reads_split/cell_TCGTCAATTGTC_reads.fastq.gz
cell_CCGTCGGACACC	./macosko/1m_reads/kmer_7/reads_split/cell_CCGTCGGACACC.umi.txt	./macosko/1m_reads/kmer_7/reads_split/cell_CCGTCGGACACC_reads.fastq.gz
cell_CCTATTGTGGGA	./macosko/1m_reads/kmer_7/reads_split/cell_CCTATTGTGGGA.umi.txt	./macosko/1m_reads/kmer_7/reads_split/cell_CCTATTGTGGGA_reads.fastq.gz
cell_ACTTGCCGGAAT	./macosko/1m_reads/kmer_7/reads_split/cell_ACTTGCCGGAAT.umi.txt	./macosko/1m_reads/kmer_7/reads_split/cell_ACTTGCCGGAAT_reads.fastq.gz
cell_TTAGGTCTCCTT	./macosko/1m_reads/kmer_7/reads_split/cell_TTAGGTCTCCTT.umi.txt	./macosko/1m_reads/kmer_7/reads_split/cell_TTAGGTCTCCTT_reads.fastq.gz
cell_GTTCGTCCCGCC	./macosko/1m_reads/kmer_7/reads_split/cell_GTTCGTCCCGCC.umi.txt	./macosko/1m_reads/kmer_7/reads_split/cell_GTTCGTCCCGCC_reads.fastq.gz
cell_AGGTGTTGTCGA	./macosko/1m_reads/kmer_7/reads_split/cell_AGGTGTTGTCGA.umi.txt	./macosko/1m_reads/kmer_7/reads_split/cell_AGGTGTTGTCGA_reads.fastq.gz
cell_AAGACGGTTTCT	./macosko/1m_reads/kmer_7/reads_split/cell_AAGACGGTTTCT.umi.txt	./macosko/1m_reads/kmer_7/reads_split/cell_AAGACGGTTTCT_reads.fastq.gz
cell_TTCTCGTCTAAG	./macosko/1m_reads/kmer_7/reads_split/cell_TTCTCGTCTAAG.umi.txt	./macosko/1m_reads/kmer_7/reads_split/cell_TTCTCGTCTAAG_reads.fastq.gz
cell_CCCATACCATTT	./macosko/1m_reads/kmer_7/reads_split/cell_CCCATACCATTT.umi.txt	./macosko/1m_reads/kmer_7/reads_split/cell_CCCATACCATTT_reads.fastq.gz
cell_AGAGACTACCCC	./macosko/1m_reads/kmer_7/reads_split/cell_AGAGACTACCCC.umi.txt	./macosko/1m_reads/kmer_7/reads_split/cell_AGAGACTACCCC_reads.fastq.gz
cell_TCCTAGGACCCG	./macosko/1m_reads/kmer_7/reads_split/cell_TCCTAGGACCCG.umi.txt	./macosko/1m_reads/kmer_7/reads_split/cell_TCCTAGGACCCG_reads.fastq.gz
cell_TAATCTAGTCTC	./macosko/1m_reads/kmer_7/reads_split/cell_TAATCTAGTCTC.umi.txt	./macosko/1m_reads/kmer_7/reads_split/cell_TAATCTAGTCTC_reads.fastq.gz
cell_CGTCCCGGCATC	./macosko/1m_reads/kmer_7/reads_split/cell_CGTCCCGGCATC.umi.txt	./macosko/1m_reads/kmer_7/reads_split/cell_CGTCCCGGCATC_reads.fastq.gz
cell_AGGGTAAGGGCC	./macosko/1m_reads/kmer_7/reads_split/cell_AGGGTAAGGGCC.umi.txt	./macosko/1m_reads/kmer_7/reads_split/cell_AGGGTAAGGGCC_reads.fastq.gz
cell_ATCGGAAAAGCC	./macosko/1m_reads/kmer_7/reads_split/cell_ATCGGAAAAGCC.umi.txt	./macosko/1m_reads/kmer_7/reads_split/cell_ATCGGAAAAGCC_reads.fastq.gz
cell_CGCCGTGGCGCC	./macosko/1m_reads/kmer_7/reads_split/cell_CGCCGTGGCGCC.umi.txt	./macosko/1m_reads/kmer_7/reads_split/cell_CGCCGTGGCGCC_reads.fastq.gz
cell_TTGCATCGAGCC	./macosko/1m_reads/kmer_7/reads_split/cell_TTGCATCGAGCC.umi.txt	./macosko/1m_reads/kmer_7/reads_split/cell_TTGCATCGAGCC_reads.fastq.gz
cell_AGGCTTCCCTTA	./macosko/1m_reads/kmer_7/reads_split/cell_AGGCTTCCCTTA.umi.txt	./macosko/1m_reads/kmer_7/reads_split/cell_AGGCTTCCCTTA_reads.fastq.gz
cell_TGTGTGCAAGAT	./macosko/1m_reads/kmer_7/reads_split/cell_TGTGTGCAAGAT.umi.txt	./macosko/1m_reads/kmer_7/reads_split/cell_TGTGTGCAAGAT_reads.fastq.gz
cell_CATCAAAAGGTA	./macosko/1m_reads/kmer_7/reads_split/cell_CATCAAAAGGTA.umi.txt	./macosko/1m_reads/kmer_7/reads_split/cell_CATCAAAAGGTA_reads.fastq.gz
cell_AGCAAATTTTGT	./macosko/1m_reads/kmer_7/reads_split/cell_AGCAAATTTTGT.umi.txt	./macosko/1m_reads/kmer_7/reads_split/cell_AGCAAATTTTGT_reads.fastq.gz
cell_TCAAGGCGTGTG	./macosko/1m_reads/kmer_7/reads_split/cell_TCAAGGCGTGTG.umi.txt	./macosko/1m_reads/kmer_7/reads_split/cell_TCAAGGCGTGTG_reads.fastq.gz
cell_AGCCGTCGATGA	./macosko/1m_reads/kmer_7/reads_split/cell_AGCCGTCGATGA.umi.txt	./macosko/1m_reads/kmer_7/reads_split/cell_AGCCGTCGATGA_reads.fastq.gz
cell_GGCAACTATCAA	./macosko/1m_reads/kmer_7/reads_split/cell_GGCAACTATCAA.umi.txt	./macosko/1m_reads/kmer_7/reads_split/cell_GGCAACTATCAA_reads.fastq.gz
cell_GAACTCATCGCT	./macosko/1m_reads/kmer_7/reads_split/cell_GAACTCATCGCT.umi.txt	./macosko/1m_reads/kmer_7/reads_split/cell_GAACTCATCGCT_reads.fastq.gz
cell_TGATGGAATAGA	./macosko/1m_reads/kmer_7/reads_split/cell_TGATGGAATAGA.umi.txt	./macosko/1m_reads/kmer_7/reads_split/cell_TGATGGAATAGA_reads.fastq.gz
cell_CAAACCTCGAAT	./macosko/1m_reads/kmer_7/reads_split/cell_CAAACCTCGAAT.umi.txt	./macosko/1m_reads/kmer_7/reads_split/cell_CAAACCTCGAAT_reads.fastq.gz
cell_CACCGGCGACGT	./macosko/1m_reads/kmer_7/reads_split/cell_CACCGGCGACGT.umi.txt	./macosko/1m_reads/kmer_7/reads_split/cell_CACCGGCGACGT_reads.fastq.gz
cell_TTCACGTCTTTC	./macosko/1m_reads/kmer_7/reads_split/cell_TTCACGTCTTTC.umi.txt	./macosko/1m_reads/kmer_7/reads_split/cell_TTCACGTCTTTC_reads.fastq.gz
cell_GCGCGCTCACAC	./macosko/1m_reads/kmer_7/reads_split/cell_GCGCGCTCACAC.umi.txt	./macosko/1m_reads/kmer_7/reads_split/cell_GCGCGCTCACAC_reads.fastq.gz
cell_TGGAAATCAGGA	./macosko/1m_reads/kmer_7/reads_split/cell_TGGAAATCAGGA.umi.txt	./macosko/1m_reads/kmer_7/reads_split/cell_TGGAAATCAGGA_reads.fastq.gz
cell_TTCCAAAGTGGC	./macosko/1m_reads/kmer_7/reads_split/cell_TTCCAAAGTGGC.umi.txt	./macosko/1m_reads/kmer_7/reads_split/cell_TTCCAAAGTGGC_reads.fastq.gz
cell_TTCGGCGAGATC	./macosko/1m_reads/kmer_7/reads_split/cell_TTCGGCGAGATC.umi.txt	./macosko/1m_reads/kmer_7/reads_split/cell_TTCGGCGAGATC_reads.fastq.gz
cell_AGTCCGGATAAC	./macosko/1m_reads/kmer_7/reads_split/cell_AGTCCGGATAAC.umi.txt	./macosko/1m_reads/kmer_7/reads_split/cell_AGTCCGGATAAC_reads.fastq.gz
cell_ACTCAGTAGATA	./macosko/1m_reads/kmer_7/reads_split/cell_ACTCAGTAGATA.umi.txt	./macosko/1m_reads/kmer_7/reads_split/cell_ACTCAGTAGATA_reads.fastq.gz
cell_GAGTACCGAACA	./macosko/1m_reads/kmer_7/reads_split/cell_GAGTACCGAACA.umi.txt	./macosko/1m_reads/kmer_7/reads_split/cell_GAGTACCGAACA_reads.fastq.gz
cell_TATATGGTCGGA	./macosko/1m_reads/kmer_7/reads_split/cell_TATATGGTCGGA.umi.txt	./macosko/1m_reads/kmer_7/reads_split/cell_TATATGGTCGGA_reads.fastq.gz
cell_CCCAGGCTAGGG	./macosko/1m_reads/kmer_7/reads_split/cell_CCCAGGCTAGGG.umi.txt	./macosko/1m_reads/kmer_7/reads_split/cell_CCCAGGCTAGGG_reads.fastq.gz
cell_GCGTCACTGAAC	./macosko/1m_reads/kmer_7/reads_split/cell_GCGTCACTGAAC.umi.txt	./macosko/1m_reads/kmer_7/reads_split/cell_GCGTCACTGAAC_reads.fastq.gz
cell_CGTATGAAGGTC	./macosko/1m_reads/kmer_7/reads_split/cell_CGTATGAAGGTC.umi.txt	./macosko/1m_reads/kmer_7/reads_split/cell_CGTATGAAGGTC_reads.fastq.gz
cell_ACCTGAATACGA	./macosko/1m_reads/kmer_7/reads_split/cell_ACCTGAATACGA.umi.txt	./macosko/1m_reads/kmer_7/reads_split/cell_ACCTGAATACGA_reads.fastq.gz
cell_TTGGGAAACAAG	./macosko/1m_reads/kmer_7/reads_split/cell_TTGGGAAACAAG.umi.txt	./macosko/1m_reads/kmer_7/reads_split/cell_TTGGGAAACAAG_reads.fastq.gz
cell_TACTCTACAATC	./macosko/1m_reads/kmer_7/reads_split/cell_TACTCTACAATC.umi.txt	./macosko/1m_reads/kmer_7/reads_split/cell_TACTCTACAATC_reads.fastq.gz
cell_GCTGTGTGGCGA	./macosko/1m_reads/kmer_7/reads_split/cell_GCTGTGTGGCGA.umi.txt	./macosko/1m_reads/kmer_7/reads_split/cell_GCTGTGTGGCGA_reads.fastq.gz
cell_TGTTGTGTGGCA	./macosko/1m_reads/kmer_7/reads_split/cell_TGTTGTGTGGCA.umi.txt	./macosko/1m_reads/kmer_7/reads_split/cell_TGTTGTGTGGCA_reads.fastq.gz
cell_TTTTAGCTGATA	./macosko/1m_reads/kmer_7/reads_split/cell_TTTTAGCTGATA.umi.txt	./macosko/1m_reads/kmer_7/reads_split/cell_TTTTAGCTGATA_reads.fastq.gz
cell_CGACTCGGCGAC	./macosko/1m_reads/kmer_7/reads_split/cell_CGACTCGGCGAC.umi.txt	./macosko/1m_reads/kmer_7/reads_split/cell_CGACTCGGCGAC_reads.fastq.gz
cell_GACTTATTGCTG	./macosko/1m_reads/kmer_7/reads_split/cell_GACTTATTGCTG.umi.txt	./macosko/1m_reads/kmer_7/reads_split/cell_GACTTATTGCTG_reads.fastq.gz
cell_CTAGGCTCACTG	./macosko/1m_reads/kmer_7/reads_split/cell_CTAGGCTCACTG.umi.txt	./macosko/1m_reads/kmer_7/reads_split/cell_CTAGGCTCACTG_reads.fastq.gz
cell_GGTTGGAGTTGC	./macosko/1m_reads/kmer_7/reads_split/cell_GGTTGGAGTTGC.umi.txt	./macosko/1m_reads/kmer_7/reads_split/cell_GGTTGGAGTTGC_reads.fastq.gz
cell_ATTATAACAAGG	./macosko/1m_reads/kmer_7/reads_split/cell_ATTATAACAAGG.umi.txt	./macosko/1m_reads/kmer_7/reads_split/cell_ATTATAACAAGG_reads.fastq.gz
cell_ATAAGTCCTTTA	./macosko/1m_reads/kmer_7/reads_split/cell_ATAAGTCCTTTA.umi.txt	./macosko/1m_reads/kmer_7/reads_split/cell_ATAAGTCCTTTA_reads.fastq.gz
cell_AGTGGGGATGGG	./macosko/1m_reads/kmer_7/reads_split/cell_AGTGGGGATGGG.umi.txt	./macosko/1m_reads/kmer_7/reads_split/cell_AGTGGGGATGGG_reads.fastq.gz
cell_ATTACGATTACA	./macosko/1m_reads/kmer_7/reads_split/cell_ATTACGATTACA.umi.txt	./macosko/1m_reads/kmer_7/reads_split/cell_ATTACGATTACA_reads.fastq.gz
cell_TGTCTTGATAAT	./macosko/1m_reads/kmer_7/reads_split/cell_TGTCTTGATAAT.umi.txt	./macosko/1m_reads/kmer_7/reads_split/cell_TGTCTTGATAAT_reads.fastq.gz
cell_GGGAATTGTAAA	./macosko/1m_reads/kmer_7/reads_split/cell_GGGAATTGTAAA.umi.txt	./macosko/1m_reads/kmer_7/reads_split/cell_GGGAATTGTAAA_reads.fastq.gz
cell_GTCTTACATGCC	./macosko/1m_reads/kmer_7/reads_split/cell_GTCTTACATGCC.umi.txt	./macosko/1m_reads/kmer_7/reads_split/cell_GTCTTACATGCC_reads.fastq.gz
cell_TGTGGTTGAACG	./macosko/1m_reads/kmer_7/reads_split/cell_TGTGGTTGAACG.umi.txt	./macosko/1m_reads/kmer_7/reads_split/cell_TGTGGTTGAACG_reads.fastq.gz
cell_CCAACTGCTTAG	./macosko/1m_reads/kmer_7/reads_split/cell_CCAACTGCTTAG.umi.txt	./macosko/1m_reads/kmer_7/reads_split/cell_CCAACTGCTTAG_reads.fastq.gz
cell_ATATCACCCTGC	./macosko/1m_reads/kmer_7/reads_split/cell_ATATCACCCTGC.umi.txt	./macosko/1m_reads/kmer_7/reads_split/cell_ATATCACCCTGC_reads.fastq.gz
cell_TTAGCTTGCCGA	./macosko/1m_reads/kmer_7/reads_split/cell_TTAGCTTGCCGA.umi.txt	./macosko/1m_reads/kmer_7/reads_split/cell_TTAGCTTGCCGA_reads.fastq.gz
cell_ATCAGTTTACCG	./macosko/1m_reads/kmer_7/reads_split/cell_ATCAGTTTACCG.umi.txt	./macosko/1m_reads/kmer_7/reads_split/cell_ATCAGTTTACCG_reads.fastq.gz
cell_CCCTGGTCCGCA	./macosko/1m_reads/kmer_7/reads_split/cell_CCCTGGTCCGCA.umi.txt	./macosko/1m_reads/kmer_7/reads_split/cell_CCCTGGTCCGCA_reads.fastq.gz
cell_GCTACGTACCCA	./macosko/1m_reads/kmer_7/reads_split/cell_GCTACGTACCCA.umi.txt	./macosko/1m_reads/kmer_7/reads_split/cell_GCTACGTACCCA_reads.fastq.gz
cell_CTTACCCGGATG	./macosko/1m_reads/kmer_7/reads_split/cell_CTTACCCGGATG.umi.txt	./macosko/1m_reads/kmer_7/reads_split/cell_CTTACCCGGATG_reads.fastq.gz
cell_CAGCCCGTTTTT	./macosko/1m_reads/kmer_7/reads_split/cell_CAGCCCGTTTTT.umi.txt	./macosko/1m_reads/kmer_7/reads_split/cell_CAGCCCGTTTTT_reads.fastq.gz
cell_CCATGTGATGTC	./macosko/1m_reads/kmer_7/reads_split/cell_CCATGTGATGTC.umi.txt	./macosko/1m_reads/kmer_7/reads_split/cell_CCATGTGATGTC_reads.fastq.gz
cell_TGGGCCGAAGCC	./macosko/1m_reads/kmer_7/reads_split/cell_TGGGCCGAAGCC.umi.txt	./macosko/1m_reads/kmer_7/reads_split/cell_TGGGCCGAAGCC_reads.fastq.gz
cell_GCGACCAGGAAT	./macosko/1m_reads/kmer_7/reads_split/cell_GCGACCAGGAAT.umi.txt	./macosko/1m_reads/kmer_7/reads_split/cell_GCGACCAGGAAT_reads.fastq.gz
cell_AGTACTCCTAGG	./macosko/1m_reads/kmer_7/reads_split/cell_AGTACTCCTAGG.umi.txt	./macosko/1m_reads/kmer_7/reads_split/cell_AGTACTCCTAGG_reads.fastq.gz
cell_ATCATAGGTAAG	./macosko/1m_reads/kmer_7/reads_split/cell_ATCATAGGTAAG.umi.txt	./macosko/1m_reads/kmer_7/reads_split/cell_ATCATAGGTAAG_reads.fastq.gz
cell_GGCAGACTCCGA	./macosko/1m_reads/kmer_7/reads_split/cell_GGCAGACTCCGA.umi.txt	./macosko/1m_reads/kmer_7/reads_split/cell_GGCAGACTCCGA_reads.fastq.gz
cell_ACCCTGTCTCTT	./macosko/1m_reads/kmer_7/reads_split/cell_ACCCTGTCTCTT.umi.txt	./macosko/1m_reads/kmer_7/reads_split/cell_ACCCTGTCTCTT_reads.fastq.gz
cell_AATATTCAACGC	./macosko/1m_reads/kmer_7/reads_split/cell_AATATTCAACGC.umi.txt	./macosko/1m_reads/kmer_7/reads_split/cell_AATATTCAACGC_reads.fastq.gz
cell_TTTGTGAGGGTC	./macosko/1m_reads/kmer_7/reads_split/cell_TTTGTGAGGGTC.umi.txt	./macosko/1m_reads/kmer_7/reads_split/cell_TTTGTGAGGGTC_reads.fastq.gz
cell_GGCGATGGTCAA	./macosko/1m_reads/kmer_7/reads_split/cell_GGCGATGGTCAA.umi.txt	./macosko/1m_reads/kmer_7/reads_split/cell_GGCGATGGTCAA_reads.fastq.gz
cell_CGGTGACTCCTA	./macosko/1m_reads/kmer_7/reads_split/cell_CGGTGACTCCTA.umi.txt	./macosko/1m_reads/kmer_7/reads_split/cell_CGGTGACTCCTA_reads.fastq.gz
cell_TCTTAATTAATA	./macosko/1m_reads/kmer_7/reads_split/cell_TCTTAATTAATA.umi.txt	./macosko/1m_reads/kmer_7/reads_split/cell_TCTTAATTAATA_reads.fastq.gz
cell_TAGCCACGACAT	./macosko/1m_reads/kmer_7/reads_split/cell_TAGCCACGACAT.umi.txt	./macosko/1m_reads/kmer_7/reads_split/cell_TAGCCACGACAT_reads.fastq.gz
cell_TGATTGATAGAT	./macosko/1m_reads/kmer_7/reads_split/cell_TGATTGATAGAT.umi.txt	./macosko/1m_reads/kmer_7/reads_split/cell_TGATTGATAGAT_reads.fastq.gz
cell_CAGTCAATCTAA	./macosko/1m_reads/kmer_7/reads_split/cell_CAGTCAATCTAA.umi.txt	./macosko/1m_reads/kmer_7/reads_split/cell_CAGTCAATCTAA_reads.fastq.gz
cell_CTATTAGGCGTT	./macosko/1m_reads/kmer_7/reads_split/cell_CTATTAGGCGTT.umi.txt	./macosko/1m_reads/kmer_7/reads_split/cell_CTATTAGGCGTT_reads.fastq.gz
cell_GGTTGGCATGGT	./macosko/1m_reads/kmer_7/reads_split/cell_GGTTGGCATGGT.umi.txt	./macosko/1m_reads/kmer_7/reads_split/cell_GGTTGGCATGGT_reads.fastq.gz
cell_AATTGATGGACA	./macosko/1m_reads/kmer_7/reads_split/cell_AATTGATGGACA.umi.txt	./macosko/1m_reads/kmer_7/reads_split/cell_AATTGATGGACA_reads.fastq.gz
cell_TAGGAAATGACG	./macosko/1m_reads/kmer_7/reads_split/cell_TAGGAAATGACG.umi.txt	./macosko/1m_reads/kmer_7/reads_split/cell_TAGGAAATGACG_reads.fastq.gz
cell_AAGTGTGGAGCA	./macosko/1m_reads/kmer_7/reads_split/cell_AAGTGTGGAGCA.umi.txt	./macosko/1m_reads/kmer_7/reads_split/cell_AAGTGTGGAGCA_reads.fastq.gz
cell_TCATCGATTATG	./macosko/1m_reads/kmer_7/reads_split/cell_TCATCGATTATG.umi.txt	./macosko/1m_reads/kmer_7/reads_split/cell_TCATCGATTATG_reads.fastq.gz
cell_TACTACCGGAGA	./macosko/1m_reads/kmer_7/reads_split/cell_TACTACCGGAGA.umi.txt	./macosko/1m_reads/kmer_7/reads_split/cell_TACTACCGGAGA_reads.fastq.gz
cell_ATCTTTACTCGA	./macosko/1m_reads/kmer_7/reads_split/cell_ATCTTTACTCGA.umi.txt	./macosko/1m_reads/kmer_7/reads_split/cell_ATCTTTACTCGA_reads.fastq.gz
cell_AATGTGCCACCC	./macosko/1m_reads/kmer_7/reads_split/cell_AATGTGCCACCC.umi.txt	./macosko/1m_reads/kmer_7/reads_split/cell_AATGTGCCACCC_reads.fastq.gz
cell_GAATTGCCAGAC	./macosko/1m_reads/kmer_7/reads_split/cell_GAATTGCCAGAC.umi.txt	./macosko/1m_reads/kmer_7/reads_split/cell_GAATTGCCAGAC_reads.fastq.gz
cell_TGTTATTCCGTC	./macosko/1m_reads/kmer_7/reads_split/cell_TGTTATTCCGTC.umi.txt	./macosko/1m_reads/kmer_7/reads_split/cell_TGTTATTCCGTC_reads.fastq.gz
cell_TTCACCGCCCCC	./macosko/1m_reads/kmer_7/reads_split/cell_TTCACCGCCCCC.umi.txt	./macosko/1m_reads/kmer_7/reads_split/cell_TTCACCGCCCCC_reads.fastq.gz
cell_GACGTGTGGACA	./macosko/1m_reads/kmer_7/reads_split/cell_GACGTGTGGACA.umi.txt	./macosko/1m_reads/kmer_7/reads_split/cell_GACGTGTGGACA_reads.fastq.gz
cell_GGGTAGGTACCC	./macosko/1m_reads/kmer_7/reads_split/cell_GGGTAGGTACCC.umi.txt	./macosko/1m_reads/kmer_7/reads_split/cell_GGGTAGGTACCC_reads.fastq.gz
cell_CCAGCATACTGC	./macosko/1m_reads/kmer_7/reads_split/cell_CCAGCATACTGC.umi.txt	./macosko/1m_reads/kmer_7/reads_split/cell_CCAGCATACTGC_reads.fastq.gz
cell_CCCGAAGCGCGG	./macosko/1m_reads/kmer_7/reads_split/cell_CCCGAAGCGCGG.umi.txt	./macosko/1m_reads/kmer_7/reads_split/cell_CCCGAAGCGCGG_reads.fastq.gz
cell_GCAGAGTCGTTC	./macosko/1m_reads/kmer_7/reads_split/cell_GCAGAGTCGTTC.umi.txt	./macosko/1m_reads/kmer_7/reads_split/cell_GCAGAGTCGTTC_reads.fastq.gz
cell_GCGATGCGATCC	./macosko/1m_reads/kmer_7/reads_split/cell_GCGATGCGATCC.umi.txt	./macosko/1m_reads/kmer_7/reads_split/cell_GCGATGCGATCC_reads.fastq.gz
cell_TTGTCTAAGTCC	./macosko/1m_reads/kmer_7/reads_split/cell_TTGTCTAAGTCC.umi.txt	./macosko/1m_reads/kmer_7/reads_split/cell_TTGTCTAAGTCC_reads.fastq.gz
cell_ACCTCAGTACGC	./macosko/1m_reads/kmer_7/reads_split/cell_ACCTCAGTACGC.umi.txt	./macosko/1m_reads/kmer_7/reads_split/cell_ACCTCAGTACGC_reads.fastq.gz
cell_CTAAAGGCCGCA	./macosko/1m_reads/kmer_7/reads_split/cell_CTAAAGGCCGCA.umi.txt	./macosko/1m_reads/kmer_7/reads_split/cell_CTAAAGGCCGCA_reads.fastq.gz
cell_CCAATGCAAGCG	./macosko/1m_reads/kmer_7/reads_split/cell_CCAATGCAAGCG.umi.txt	./macosko/1m_reads/kmer_7/reads_split/cell_CCAATGCAAGCG_reads.fastq.gz
cell_AGCTCGGCCCCC	./macosko/1m_reads/kmer_7/reads_split/cell_AGCTCGGCCCCC.umi.txt	./macosko/1m_reads/kmer_7/reads_split/cell_AGCTCGGCCCCC_reads.fastq.gz
cell_ATGCACAGGGTA	./macosko/1m_reads/kmer_7/reads_split/cell_ATGCACAGGGTA.umi.txt	./macosko/1m_reads/kmer_7/reads_split/cell_ATGCACAGGGTA_reads.fastq.gz
cell_TTACGTGGAGGC	./macosko/1m_reads/kmer_7/reads_split/cell_TTACGTGGAGGC.umi.txt	./macosko/1m_reads/kmer_7/reads_split/cell_TTACGTGGAGGC_reads.fastq.gz
cell_CGAGGCAAGTGA	./macosko/1m_reads/kmer_7/reads_split/cell_CGAGGCAAGTGA.umi.txt	./macosko/1m_reads/kmer_7/reads_split/cell_CGAGGCAAGTGA_reads.fastq.gz
cell_ACCTAAGTTGCT	./macosko/1m_reads/kmer_7/reads_split/cell_ACCTAAGTTGCT.umi.txt	./macosko/1m_reads/kmer_7/reads_split/cell_ACCTAAGTTGCT_reads.fastq.gz
cell_CCTTTCAACGTT	./macosko/1m_reads/kmer_7/reads_split/cell_CCTTTCAACGTT.umi.txt	./macosko/1m_reads/kmer_7/reads_split/cell_CCTTTCAACGTT_reads.fastq.gz
cell_GCTGTCGGAAGG	./macosko/1m_reads/kmer_7/reads_split/cell_GCTGTCGGAAGG.umi.txt	./macosko/1m_reads/kmer_7/reads_split/cell_GCTGTCGGAAGG_reads.fastq.gz
cell_CCGGTCGTGCTG	./macosko/1m_reads/kmer_7/reads_split/cell_CCGGTCGTGCTG.umi.txt	./macosko/1m_reads/kmer_7/reads_split/cell_CCGGTCGTGCTG_reads.fastq.gz
cell_GCCGAATGGCTG	./macosko/1m_reads/kmer_7/reads_split/cell_GCCGAATGGCTG.umi.txt	./macosko/1m_reads/kmer_7/reads_split/cell_GCCGAATGGCTG_reads.fastq.gz
cell_TACTCGTTATGA	./macosko/1m_reads/kmer_7/reads_split/cell_TACTCGTTATGA.umi.txt	./macosko/1m_reads/kmer_7/reads_split/cell_TACTCGTTATGA_reads.fastq.gz
cell_AGCTCTAAGTCG	./macosko/1m_reads/kmer_7/reads_split/cell_AGCTCTAAGTCG.umi.txt	./macosko/1m_reads/kmer_7/reads_split/cell_AGCTCTAAGTCG_reads.fastq.gz
cell_CATCTCAGGTAA	./macosko/1m_reads/kmer_7/reads_split/cell_CATCTCAGGTAA.umi.txt	./macosko/1m_reads/kmer_7/reads_split/cell_CATCTCAGGTAA_reads.fastq.gz
cell_CACCAGGTTGAA	./macosko/1m_reads/kmer_7/reads_split/cell_CACCAGGTTGAA.umi.txt	./macosko/1m_reads/kmer_7/reads_split/cell_CACCAGGTTGAA_reads.fastq.gz
cell_CCTTTAGTAAAC	./macosko/1m_reads/kmer_7/reads_split/cell_CCTTTAGTAAAC.umi.txt	./macosko/1m_reads/kmer_7/reads_split/cell_CCTTTAGTAAAC_reads.fastq.gz
cell_AGCGCGGCCGCG	./macosko/1m_reads/kmer_7/reads_split/cell_AGCGCGGCCGCG.umi.txt	./macosko/1m_reads/kmer_7/reads_split/cell_AGCGCGGCCGCG_reads.fastq.gz
cell_TAACCCCTAGCC	./macosko/1m_reads/kmer_7/reads_split/cell_TAACCCCTAGCC.umi.txt	./macosko/1m_reads/kmer_7/reads_split/cell_TAACCCCTAGCC_reads.fastq.gz
cell_TCGACCCCTTCA	./macosko/1m_reads/kmer_7/reads_split/cell_TCGACCCCTTCA.umi.txt	./macosko/1m_reads/kmer_7/reads_split/cell_TCGACCCCTTCA_reads.fastq.gz
cell_AATCCCTTAGAG	./macosko/1m_reads/kmer_7/reads_split/cell_AATCCCTTAGAG.umi.txt	./macosko/1m_reads/kmer_7/reads_split/cell_AATCCCTTAGAG_reads.fastq.gz
cell_AGTTCGTTTAGC	./macosko/1m_reads/kmer_7/reads_split/cell_AGTTCGTTTAGC.umi.txt	./macosko/1m_reads/kmer_7/reads_split/cell_AGTTCGTTTAGC_reads.fastq.gz
cell_GAGTTAAAGGCC	./macosko/1m_reads/kmer_7/reads_split/cell_GAGTTAAAGGCC.umi.txt	./macosko/1m_reads/kmer_7/reads_split/cell_GAGTTAAAGGCC_reads.fastq.gz
cell_AGCTACCTTGGC	./macosko/1m_reads/kmer_7/reads_split/cell_AGCTACCTTGGC.umi.txt	./macosko/1m_reads/kmer_7/reads_split/cell_AGCTACCTTGGC_reads.fastq.gz
cell_AGTGAGTTCAAA	./macosko/1m_reads/kmer_7/reads_split/cell_AGTGAGTTCAAA.umi.txt	./macosko/1m_reads/kmer_7/reads_split/cell_AGTGAGTTCAAA_reads.fastq.gz
cell_GTTATCCCTAGC	./macosko/1m_reads/kmer_7/reads_split/cell_GTTATCCCTAGC.umi.txt	./macosko/1m_reads/kmer_7/reads_split/cell_GTTATCCCTAGC_reads.fastq.gz
cell_ATGGAAAGCACC	./macosko/1m_reads/kmer_7/reads_split/cell_ATGGAAAGCACC.umi.txt	./macosko/1m_reads/kmer_7/reads_split/cell_ATGGAAAGCACC_reads.fastq.gz
cell_GTGAGCGTTATA	./macosko/1m_reads/kmer_7/reads_split/cell_GTGAGCGTTATA.umi.txt	./macosko/1m_reads/kmer_7/reads_split/cell_GTGAGCGTTATA_reads.fastq.gz
cell_CACCTGTCAACA	./macosko/1m_reads/kmer_7/reads_split/cell_CACCTGTCAACA.umi.txt	./macosko/1m_reads/kmer_7/reads_split/cell_CACCTGTCAACA_reads.fastq.gz
cell_ACTAATCCAGCC	./macosko/1m_reads/kmer_7/reads_split/cell_ACTAATCCAGCC.umi.txt	./macosko/1m_reads/kmer_7/reads_split/cell_ACTAATCCAGCC_reads.fastq.gz
cell_CCTTGCCTCGTC	./macosko/1m_reads/kmer_7/reads_split/cell_CCTTGCCTCGTC.umi.txt	./macosko/1m_reads/kmer_7/reads_split/cell_CCTTGCCTCGTC_reads.fastq.gz
cell_TTACCTGCGTGT	./macosko/1m_reads/kmer_7/reads_split/cell_TTACCTGCGTGT.umi.txt	./macosko/1m_reads/kmer_7/reads_split/cell_TTACCTGCGTGT_reads.fastq.gz
cell_GAACGGAAGCAC	./macosko/1m_reads/kmer_7/reads_split/cell_GAACGGAAGCAC.umi.txt	./macosko/1m_reads/kmer_7/reads_split/cell_GAACGGAAGCAC_reads.fastq.gz
cell_GTAAGCTTGTAT	./macosko/1m_reads/kmer_7/reads_split/cell_GTAAGCTTGTAT.umi.txt	./macosko/1m_reads/kmer_7/reads_split/cell_GTAAGCTTGTAT_reads.fastq.gz
cell_GTATCTTACGCA	./macosko/1m_reads/kmer_7/reads_split/cell_GTATCTTACGCA.umi.txt	./macosko/1m_reads/kmer_7/reads_split/cell_GTATCTTACGCA_reads.fastq.gz
cell_GACAGGCTACCA	./macosko/1m_reads/kmer_7/reads_split/cell_GACAGGCTACCA.umi.txt	./macosko/1m_reads/kmer_7/reads_split/cell_GACAGGCTACCA_reads.fastq.gz
cell_ATCGTAGGGAGC	./macosko/1m_reads/kmer_7/reads_split/cell_ATCGTAGGGAGC.umi.txt	./macosko/1m_reads/kmer_7/reads_split/cell_ATCGTAGGGAGC_reads.fastq.gz
cell_TACCGACGCGCT	./macosko/1m_reads/kmer_7/reads_split/cell_TACCGACGCGCT.umi.txt	./macosko/1m_reads/kmer_7/reads_split/cell_TACCGACGCGCT_reads.fastq.gz
cell_AAAAAAAAAAAA	./macosko/1m_reads/kmer_7/reads_split/cell_AAAAAAAAAAAA.umi.txt	./macosko/1m_reads/kmer_7/reads_split/cell_AAAAAAAAAAAA_reads.fastq.gz
cell_TGATAAGGACAC	./macosko/1m_reads/kmer_7/reads_split/cell_TGATAAGGACAC.umi.txt	./macosko/1m_reads/kmer_7/reads_split/cell_TGATAAGGACAC_reads.fastq.gz
cell_CAGGGTTTGCAC	./macosko/1m_reads/kmer_7/reads_split/cell_CAGGGTTTGCAC.umi.txt	./macosko/1m_reads/kmer_7/reads_split/cell_CAGGGTTTGCAC_reads.fastq.gz
cell_GACGGCTATTCC	./macosko/1m_reads/kmer_7/reads_split/cell_GACGGCTATTCC.umi.txt	./macosko/1m_reads/kmer_7/reads_split/cell_GACGGCTATTCC_reads.fastq.gz
cell_CTCGGCTGTGTT	./macosko/1m_reads/kmer_7/reads_split/cell_CTCGGCTGTGTT.umi.txt	./macosko/1m_reads/kmer_7/reads_split/cell_CTCGGCTGTGTT_reads.fastq.gz
cell_CCTTGGATATAT	./macosko/1m_reads/kmer_7/reads_split/cell_CCTTGGATATAT.umi.txt	./macosko/1m_reads/kmer_7/reads_split/cell_CCTTGGATATAT_reads.fastq.gz
cell_ACCAGACCGGAA	./macosko/1m_reads/kmer_7/reads_split/cell_ACCAGACCGGAA.umi.txt	./macosko/1m_reads/kmer_7/reads_split/cell_ACCAGACCGGAA_reads.fastq.gz
cell_TTACCAGCGCCA	./macosko/1m_reads/kmer_7/reads_split/cell_TTACCAGCGCCA.umi.txt	./macosko/1m_reads/kmer_7/reads_split/cell_TTACCAGCGCCA_reads.fastq.gz
cell_CAGCGGATCGTC	./macosko/1m_reads/kmer_7/reads_split/cell_CAGCGGATCGTC.umi.txt	./macosko/1m_reads/kmer_7/reads_split/cell_CAGCGGATCGTC_reads.fastq.gz
cell_ATTCGTAGCGAC	./macosko/1m_reads/kmer_7/reads_split/cell_ATTCGTAGCGAC.umi.txt	./macosko/1m_reads/kmer_7/reads_split/cell_ATTCGTAGCGAC_reads.fastq.gz
cell_ACGCAATTTAGA	./macosko/1m_reads/kmer_7/reads_split/cell_ACGCAATTTAGA.umi.txt	./macosko/1m_reads/kmer_7/reads_split/cell_ACGCAATTTAGA_reads.fastq.gz
cell_TTGACTAGTACT	./macosko/1m_reads/kmer_7/reads_split/cell_TTGACTAGTACT.umi.txt	./macosko/1m_reads/kmer_7/reads_split/cell_TTGACTAGTACT_reads.fastq.gz
cell_TCCGCAGCAGAA	./macosko/1m_reads/kmer_7/reads_split/cell_TCCGCAGCAGAA.umi.txt	./macosko/1m_reads/kmer_7/reads_split/cell_TCCGCAGCAGAA_reads.fastq.gz
cell_TGGCGTCGAGCT	./macosko/1m_reads/kmer_7/reads_split/cell_TGGCGTCGAGCT.umi.txt	./macosko/1m_reads/kmer_7/reads_split/cell_TGGCGTCGAGCT_reads.fastq.gz
cell_TTGACGCCACTG	./macosko/1m_reads/kmer_7/reads_split/cell_TTGACGCCACTG.umi.txt	./macosko/1m_reads/kmer_7/reads_split/cell_TTGACGCCACTG_reads.fastq.gz
cell_CCTTTGAACAGG	./macosko/1m_reads/kmer_7/reads_split/cell_CCTTTGAACAGG.umi.txt	./macosko/1m_reads/kmer_7/reads_split/cell_CCTTTGAACAGG_reads.fastq.gz
cell_TCGGAGGCTATT	./macosko/1m_reads/kmer_7/reads_split/cell_TCGGAGGCTATT.umi.txt	./macosko/1m_reads/kmer_7/reads_split/cell_TCGGAGGCTATT_reads.fastq.gz
cell_CCCTTGACGTAA	./macosko/1m_reads/kmer_7/reads_split/cell_CCCTTGACGTAA.umi.txt	./macosko/1m_reads/kmer_7/reads_split/cell_CCCTTGACGTAA_reads.fastq.gz
cell_CTGCTCTAGGCC	./macosko/1m_reads/kmer_7/reads_split/cell_CTGCTCTAGGCC.umi.txt	./macosko/1m_reads/kmer_7/reads_split/cell_CTGCTCTAGGCC_reads.fastq.gz
cell_GGTGCGAGGTCT	./macosko/1m_reads/kmer_7/reads_split/cell_GGTGCGAGGTCT.umi.txt	./macosko/1m_reads/kmer_7/reads_split/cell_GGTGCGAGGTCT_reads.fastq.gz
cell_CCCAAGCGCCTG	./macosko/1m_reads/kmer_7/reads_split/cell_CCCAAGCGCCTG.umi.txt	./macosko/1m_reads/kmer_7/reads_split/cell_CCCAAGCGCCTG_reads.fastq.gz
cell_CTTCGACCTCAT	./macosko/1m_reads/kmer_7/reads_split/cell_CTTCGACCTCAT.umi.txt	./macosko/1m_reads/kmer_7/reads_split/cell_CTTCGACCTCAT_reads.fastq.gz
cell_TGGTGACACAGG	./macosko/1m_reads/kmer_7/reads_split/cell_TGGTGACACAGG.umi.txt	./macosko/1m_reads/kmer_7/reads_split/cell_TGGTGACACAGG_reads.fastq.gz
cell_ATTCAACTTCGA	./macosko/1m_reads/kmer_7/reads_split/cell_ATTCAACTTCGA.umi.txt	./macosko/1m_reads/kmer_7/reads_split/cell_ATTCAACTTCGA_reads.fastq.gz
cell_ACCAGCAGTCAT	./macosko/1m_reads/kmer_7/reads_split/cell_ACCAGCAGTCAT.umi.txt	./macosko/1m_reads/kmer_7/reads_split/cell_ACCAGCAGTCAT_reads.fastq.gz
cell_TCACCCCTGTTT	./macosko/1m_reads/kmer_7/reads_split/cell_TCACCCCTGTTT.umi.txt	./macosko/1m_reads/kmer_7/reads_split/cell_TCACCCCTGTTT_reads.fastq.gz
cell_GCCAACTGGGCC	./macosko/1m_reads/kmer_7/reads_split/cell_GCCAACTGGGCC.umi.txt	./macosko/1m_reads/kmer_7/reads_split/cell_GCCAACTGGGCC_reads.fastq.gz
cell_ACGGGATGGGCC	./macosko/1m_reads/kmer_7/reads_split/cell_ACGGGATGGGCC.umi.txt	./macosko/1m_reads/kmer_7/reads_split/cell_ACGGGATGGGCC_reads.fastq.gz
cell_TTCCTCGTCTGA	./macosko/1m_reads/kmer_7/reads_split/cell_TTCCTCGTCTGA.umi.txt	./macosko/1m_reads/kmer_7/reads_split/cell_TTCCTCGTCTGA_reads.fastq.gz
cell_ACTTCTGATTAT	./macosko/1m_reads/kmer_7/reads_split/cell_ACTTCTGATTAT.umi.txt	./macosko/1m_reads/kmer_7/reads_split/cell_ACTTCTGATTAT_reads.fastq.gz
cell_TTGGCCCGTCTC	./macosko/1m_reads/kmer_7/reads_split/cell_TTGGCCCGTCTC.umi.txt	./macosko/1m_reads/kmer_7/reads_split/cell_TTGGCCCGTCTC_reads.fastq.gz
cell_CAGGATGCGCAG	./macosko/1m_reads/kmer_7/reads_split/cell_CAGGATGCGCAG.umi.txt	./macosko/1m_reads/kmer_7/reads_split/cell_CAGGATGCGCAG_reads.fastq.gz
cell_GTACAACGATAC	./macosko/1m_reads/kmer_7/reads_split/cell_GTACAACGATAC.umi.txt	./macosko/1m_reads/kmer_7/reads_split/cell_GTACAACGATAC_reads.fastq.gz
cell_ACCCGTCAACAT	./macosko/1m_reads/kmer_7/reads_split/cell_ACCCGTCAACAT.umi.txt	./macosko/1m_reads/kmer_7/reads_split/cell_ACCCGTCAACAT_reads.fastq.gz
cell_GTGTGGGTCTCT	./macosko/1m_reads/kmer_7/reads_split/cell_GTGTGGGTCTCT.umi.txt	./macosko/1m_reads/kmer_7/reads_split/cell_GTGTGGGTCTCT_reads.fastq.gz
cell_ATTTAGGTGGCC	./macosko/1m_reads/kmer_7/reads_split/cell_ATTTAGGTGGCC.umi.txt	./macosko/1m_reads/kmer_7/reads_split/cell_ATTTAGGTGGCC_reads.fastq.gz
cell_CTGTGCCGACGT	./macosko/1m_reads/kmer_7/reads_split/cell_CTGTGCCGACGT.umi.txt	./macosko/1m_reads/kmer_7/reads_split/cell_CTGTGCCGACGT_reads.fastq.gz
cell_TCTTATCCACAG	./macosko/1m_reads/kmer_7/reads_split/cell_TCTTATCCACAG.umi.txt	./macosko/1m_reads/kmer_7/reads_split/cell_TCTTATCCACAG_reads.fastq.gz
cell_TATCAGTGGAGA	./macosko/1m_reads/kmer_7/reads_split/cell_TATCAGTGGAGA.umi.txt	./macosko/1m_reads/kmer_7/reads_split/cell_TATCAGTGGAGA_reads.fastq.gz
cell_AGTACCCCGTAG	./macosko/1m_reads/kmer_7/reads_split/cell_AGTACCCCGTAG.umi.txt	./macosko/1m_reads/kmer_7/reads_split/cell_AGTACCCCGTAG_reads.fastq.gz
cell_GCCTCATGTGAA	./macosko/1m_reads/kmer_7/reads_split/cell_GCCTCATGTGAA.umi.txt	./macosko/1m_reads/kmer_7/reads_split/cell_GCCTCATGTGAA_reads.fastq.gz
cell_GCGGGGAGTGAG	./macosko/1m_reads/kmer_7/reads_split/cell_GCGGGGAGTGAG.umi.txt	./macosko/1m_reads/kmer_7/reads_split/cell_GCGGGGAGTGAG_reads.fastq.gz
cell_TCCGAAATCACA	./macosko/1m_reads/kmer_7/reads_split/cell_TCCGAAATCACA.umi.txt	./macosko/1m_reads/kmer_7/reads_split/cell_TCCGAAATCACA_reads.fastq.gz
cell_ATCGTGGAAGTC	./macosko/1m_reads/kmer_7/reads_split/cell_ATCGTGGAAGTC.umi.txt	./macosko/1m_reads/kmer_7/reads_split/cell_ATCGTGGAAGTC_reads.fastq.gz
cell_AATAAAACCGCA	./macosko/1m_reads/kmer_7/reads_split/cell_AATAAAACCGCA.umi.txt	./macosko/1m_reads/kmer_7/reads_split/cell_AATAAAACCGCA_reads.fastq.gz
cell_ACGATGTGATGG	./macosko/1m_reads/kmer_7/reads_split/cell_ACGATGTGATGG.umi.txt	./macosko/1m_reads/kmer_7/reads_split/cell_ACGATGTGATGG_reads.fastq.gz
cell_ATCCTCGGGCAG	./macosko/1m_reads/kmer_7/reads_split/cell_ATCCTCGGGCAG.umi.txt	./macosko/1m_reads/kmer_7/reads_split/cell_ATCCTCGGGCAG_reads.fastq.gz
cell_GGGGAGGAGGTA	./macosko/1m_reads/kmer_7/reads_split/cell_GGGGAGGAGGTA.umi.txt	./macosko/1m_reads/kmer_7/reads_split/cell_GGGGAGGAGGTA_reads.fastq.gz
cell_GTTCGGCGATCT	./macosko/1m_reads/kmer_7/reads_split/cell_GTTCGGCGATCT.umi.txt	./macosko/1m_reads/kmer_7/reads_split/cell_GTTCGGCGATCT_reads.fastq.gz
cell_TTTAGCATTTGC	./macosko/1m_reads/kmer_7/reads_split/cell_TTTAGCATTTGC.umi.txt	./macosko/1m_reads/kmer_7/reads_split/cell_TTTAGCATTTGC_reads.fastq.gz
cell_CCACCGGGCCCG	./macosko/1m_reads/kmer_7/reads_split/cell_CCACCGGGCCCG.umi.txt	./macosko/1m_reads/kmer_7/reads_split/cell_CCACCGGGCCCG_reads.fastq.gz
cell_AGGTTCCGAAGG	./macosko/1m_reads/kmer_7/reads_split/cell_AGGTTCCGAAGG.umi.txt	./macosko/1m_reads/kmer_7/reads_split/cell_AGGTTCCGAAGG_reads.fastq.gz
cell_ATATACAACCCT	./macosko/1m_reads/kmer_7/reads_split/cell_ATATACAACCCT.umi.txt	./macosko/1m_reads/kmer_7/reads_split/cell_ATATACAACCCT_reads.fastq.gz
cell_TAATATGGCGTG	./macosko/1m_reads/kmer_7/reads_split/cell_TAATATGGCGTG.umi.txt	./macosko/1m_reads/kmer_7/reads_split/cell_TAATATGGCGTG_reads.fastq.gz
cell_TTTTGTATCACG	./macosko/1m_reads/kmer_7/reads_split/cell_TTTTGTATCACG.umi.txt	./macosko/1m_reads/kmer_7/reads_split/cell_TTTTGTATCACG_reads.fastq.gz
cell_GTAGATTGCCAC	./macosko/1m_reads/kmer_7/reads_split/cell_GTAGATTGCCAC.umi.txt	./macosko/1m_reads/kmer_7/reads_split/cell_GTAGATTGCCAC_reads.fastq.gz
cell_GAGAGGTGGTTC	./macosko/1m_reads/kmer_7/reads_split/cell_GAGAGGTGGTTC.umi.txt	./macosko/1m_reads/kmer_7/reads_split/cell_GAGAGGTGGTTC_reads.fastq.gz
cell_TCTACCATAGTA	./macosko/1m_reads/kmer_7/reads_split/cell_TCTACCATAGTA.umi.txt	./macosko/1m_reads/kmer_7/reads_split/cell_TCTACCATAGTA_reads.fastq.gz
cell_ATTAAAATTAGT	./macosko/1m_reads/kmer_7/reads_split/cell_ATTAAAATTAGT.umi.txt	./macosko/1m_reads/kmer_7/reads_split/cell_ATTAAAATTAGT_reads.fastq.gz
cell_ATTTTCGAAGGC	./macosko/1m_reads/kmer_7/reads_split/cell_ATTTTCGAAGGC.umi.txt	./macosko/1m_reads/kmer_7/reads_split/cell_ATTTTCGAAGGC_reads.fastq.gz
cell_AAACCTCTGCTG	./macosko/1m_reads/kmer_7/reads_split/cell_AAACCTCTGCTG.umi.txt	./macosko/1m_reads/kmer_7/reads_split/cell_AAACCTCTGCTG_reads.fastq.gz
cell_TGAAAGTACTAT	./macosko/1m_reads/kmer_7/reads_split/cell_TGAAAGTACTAT.umi.txt	./macosko/1m_reads/kmer_7/reads_split/cell_TGAAAGTACTAT_reads.fastq.gz
cell_GTTATATTAGGC	./macosko/1m_reads/kmer_7/reads_split/cell_GTTATATTAGGC.umi.txt	./macosko/1m_reads/kmer_7/reads_split/cell_GTTATATTAGGC_reads.fastq.gz
cell_TTATGTCTCAGG	./macosko/1m_reads/kmer_7/reads_split/cell_TTATGTCTCAGG.umi.txt	./macosko/1m_reads/kmer_7/reads_split/cell_TTATGTCTCAGG_reads.fastq.gz
cell_CAGAGTTATAGG	./macosko/1m_reads/kmer_7/reads_split/cell_CAGAGTTATAGG.umi.txt	./macosko/1m_reads/kmer_7/reads_split/cell_CAGAGTTATAGG_reads.fastq.gz
cell_GGTGGTCTTTTG	./macosko/1m_reads/kmer_7/reads_split/cell_GGTGGTCTTTTG.umi.txt	./macosko/1m_reads/kmer_7/reads_split/cell_GGTGGTCTTTTG_reads.fastq.gz
cell_GATAGGGAGGTG	./macosko/1m_reads/kmer_7/reads_split/cell_GATAGGGAGGTG.umi.txt	./macosko/1m_reads/kmer_7/reads_split/cell_GATAGGGAGGTG_reads.fastq.gz
cell_GAACAGACATCA	./macosko/1m_reads/kmer_7/reads_split/cell_GAACAGACATCA.umi.txt	./macosko/1m_reads/kmer_7/reads_split/cell_GAACAGACATCA_reads.fastq.gz
cell_CCGAATGGTCAC	./macosko/1m_reads/kmer_7/reads_split/cell_CCGAATGGTCAC.umi.txt	./macosko/1m_reads/kmer_7/reads_split/cell_CCGAATGGTCAC_reads.fastq.gz
cell_GCCTCCGGGGCC	./macosko/1m_reads/kmer_7/reads_split/cell_GCCTCCGGGGCC.umi.txt	./macosko/1m_reads/kmer_7/reads_split/cell_GCCTCCGGGGCC_reads.fastq.gz
cell_TCTCAACTCCGT	./macosko/1m_reads/kmer_7/reads_split/cell_TCTCAACTCCGT.umi.txt	./macosko/1m_reads/kmer_7/reads_split/cell_TCTCAACTCCGT_reads.fastq.gz
cell_TAACGTACAGGA	./macosko/1m_reads/kmer_7/reads_split/cell_TAACGTACAGGA.umi.txt	./macosko/1m_reads/kmer_7/reads_split/cell_TAACGTACAGGA_reads.fastq.gz
cell_ATACAACTCTCC	./macosko/1m_reads/kmer_7/reads_split/cell_ATACAACTCTCC.umi.txt	./macosko/1m_reads/kmer_7/reads_split/cell_ATACAACTCTCC_reads.fastq.gz
cell_GCAGATCGTAGG	./macosko/1m_reads/kmer_7/reads_split/cell_GCAGATCGTAGG.umi.txt	./macosko/1m_reads/kmer_7/reads_split/cell_GCAGATCGTAGG_reads.fastq.gz
cell_CGCAAGGATTTG	./macosko/1m_reads/kmer_7/reads_split/cell_CGCAAGGATTTG.umi.txt	./macosko/1m_reads/kmer_7/reads_split/cell_CGCAAGGATTTG_reads.fastq.gz
cell_CCGCGTAGAGGA	./macosko/1m_reads/kmer_7/reads_split/cell_CCGCGTAGAGGA.umi.txt	./macosko/1m_reads/kmer_7/reads_split/cell_CCGCGTAGAGGA_reads.fastq.gz
cell_AGCCCTCCCCAG	./macosko/1m_reads/kmer_7/reads_split/cell_AGCCCTCCCCAG.umi.txt	./macosko/1m_reads/kmer_7/reads_split/cell_AGCCCTCCCCAG_reads.fastq.gz
cell_CATATACTCTTA	./macosko/1m_reads/kmer_7/reads_split/cell_CATATACTCTTA.umi.txt	./macosko/1m_reads/kmer_7/reads_split/cell_CATATACTCTTA_reads.fastq.gz
cell_CGGCTCGGGTAG	./macosko/1m_reads/kmer_7/reads_split/cell_CGGCTCGGGTAG.umi.txt	./macosko/1m_reads/kmer_7/reads_split/cell_CGGCTCGGGTAG_reads.fastq.gz
cell_TGCCCCGTTAGC	./macosko/1m_reads/kmer_7/reads_split/cell_TGCCCCGTTAGC.umi.txt	./macosko/1m_reads/kmer_7/reads_split/cell_TGCCCCGTTAGC_reads.fastq.gz
cell_TCGCATTCACTT	./macosko/1m_reads/kmer_7/reads_split/cell_TCGCATTCACTT.umi.txt	./macosko/1m_reads/kmer_7/reads_split/cell_TCGCATTCACTT_reads.fastq.gz
cell_GCGTGGCAGTTG	./macosko/1m_reads/kmer_7/reads_split/cell_GCGTGGCAGTTG.umi.txt	./macosko/1m_reads/kmer_7/reads_split/cell_GCGTGGCAGTTG_reads.fastq.gz
cell_TGAAGAGGTATT	./macosko/1m_reads/kmer_7/reads_split/cell_TGAAGAGGTATT.umi.txt	./macosko/1m_reads/kmer_7/reads_split/cell_TGAAGAGGTATT_reads.fastq.gz
cell_ACCTTGCCCTGC	./macosko/1m_reads/kmer_7/reads_split/cell_ACCTTGCCCTGC.umi.txt	./macosko/1m_reads/kmer_7/reads_split/cell_ACCTTGCCCTGC_reads.fastq.gz
cell_GTTTCACCGGTC	./macosko/1m_reads/kmer_7/reads_split/cell_GTTTCACCGGTC.umi.txt	./macosko/1m_reads/kmer_7/reads_split/cell_GTTTCACCGGTC_reads.fastq.gz
cell_TGATGCTGGGCC	./macosko/1m_reads/kmer_7/reads_split/cell_TGATGCTGGGCC.umi.txt	./macosko/1m_reads/kmer_7/reads_split/cell_TGATGCTGGGCC_reads.fastq.gz
cell_CTTTCCCTGAGA	./macosko/1m_reads/kmer_7/reads_split/cell_CTTTCCCTGAGA.umi.txt	./macosko/1m_reads/kmer_7/reads_split/cell_CTTTCCCTGAGA_reads.fastq.gz
cell_TTGGCCAATAGT	./macosko/1m_reads/kmer_7/reads_split/cell_TTGGCCAATAGT.umi.txt	./macosko/1m_reads/kmer_7/reads_split/cell_TTGGCCAATAGT_reads.fastq.gz
cell_AGTTGGTTCCAA	./macosko/1m_reads/kmer_7/reads_split/cell_AGTTGGTTCCAA.umi.txt	./macosko/1m_reads/kmer_7/reads_split/cell_AGTTGGTTCCAA_reads.fastq.gz
cell_AACCGGGCGCAA	./macosko/1m_reads/kmer_7/reads_split/cell_AACCGGGCGCAA.umi.txt	./macosko/1m_reads/kmer_7/reads_split/cell_AACCGGGCGCAA_reads.fastq.gz
cell_CCAGATTAATCT	./macosko/1m_reads/kmer_7/reads_split/cell_CCAGATTAATCT.umi.txt	./macosko/1m_reads/kmer_7/reads_split/cell_CCAGATTAATCT_reads.fastq.gz
cell_CTAGTTGAACAC	./macosko/1m_reads/kmer_7/reads_split/cell_CTAGTTGAACAC.umi.txt	./macosko/1m_reads/kmer_7/reads_split/cell_CTAGTTGAACAC_reads.fastq.gz
cell_CTGCGCGGCGGC	./macosko/1m_reads/kmer_7/reads_split/cell_CTGCGCGGCGGC.umi.txt	./macosko/1m_reads/kmer_7/reads_split/cell_CTGCGCGGCGGC_reads.fastq.gz
cell_GGCATGATACTA	./macosko/1m_reads/kmer_7/reads_split/cell_GGCATGATACTA.umi.txt	./macosko/1m_reads/kmer_7/reads_split/cell_GGCATGATACTA_reads.fastq.gz
cell_GACGACCATAAT	./macosko/1m_reads/kmer_7/reads_split/cell_GACGACCATAAT.umi.txt	./macosko/1m_reads/kmer_7/reads_split/cell_GACGACCATAAT_reads.fastq.gz
cell_GTGGATCGAAGA	./macosko/1m_reads/kmer_7/reads_split/cell_GTGGATCGAAGA.umi.txt	./macosko/1m_reads/kmer_7/reads_split/cell_GTGGATCGAAGA_reads.fastq.gz
cell_TGAGTGAGGCAG	./macosko/1m_reads/kmer_7/reads_split/cell_TGAGTGAGGCAG.umi.txt	./macosko/1m_reads/kmer_7/reads_split/cell_TGAGTGAGGCAG_reads.fastq.gz
cell_ATCTATCATATT	./macosko/1m_reads/kmer_7/reads_split/cell_ATCTATCATATT.umi.txt	./macosko/1m_reads/kmer_7/reads_split/cell_ATCTATCATATT_reads.fastq.gz
cell_GTTCGATCTGCC	./macosko/1m_reads/kmer_7/reads_split/cell_GTTCGATCTGCC.umi.txt	./macosko/1m_reads/kmer_7/reads_split/cell_GTTCGATCTGCC_reads.fastq.gz
cell_TGAGCCAGGGTA	./macosko/1m_reads/kmer_7/reads_split/cell_TGAGCCAGGGTA.umi.txt	./macosko/1m_reads/kmer_7/reads_split/cell_TGAGCCAGGGTA_reads.fastq.gz
cell_CTGCTCTTTGCA	./macosko/1m_reads/kmer_7/reads_split/cell_CTGCTCTTTGCA.umi.txt	./macosko/1m_reads/kmer_7/reads_split/cell_CTGCTCTTTGCA_reads.fastq.gz
cell_ATAGTTTTTTAA	./macosko/1m_reads/kmer_7/reads_split/cell_ATAGTTTTTTAA.umi.txt	./macosko/1m_reads/kmer_7/reads_split/cell_ATAGTTTTTTAA_reads.fastq.gz
cell_CGACAGTTGGCT	./macosko/1m_reads/kmer_7/reads_split/cell_CGACAGTTGGCT.umi.txt	./macosko/1m_reads/kmer_7/reads_split/cell_CGACAGTTGGCT_reads.fastq.gz
cell_TTTCGTCTGGTT	./macosko/1m_reads/kmer_7/reads_split/cell_TTTCGTCTGGTT.umi.txt	./macosko/1m_reads/kmer_7/reads_split/cell_TTTCGTCTGGTT_reads.fastq.gz
cell_AATATTTTGAAA	./macosko/1m_reads/kmer_7/reads_split/cell_AATATTTTGAAA.umi.txt	./macosko/1m_reads/kmer_7/reads_split/cell_AATATTTTGAAA_reads.fastq.gz
cell_GAATATATCCTC	./macosko/1m_reads/kmer_7/reads_split/cell_GAATATATCCTC.umi.txt	./macosko/1m_reads/kmer_7/reads_split/cell_GAATATATCCTC_reads.fastq.gz
cell_TGTTTTTAATAC	./macosko/1m_reads/kmer_7/reads_split/cell_TGTTTTTAATAC.umi.txt	./macosko/1m_reads/kmer_7/reads_split/cell_TGTTTTTAATAC_reads.fastq.gz
cell_CACTAATAATGG	./macosko/1m_reads/kmer_7/reads_split/cell_CACTAATAATGG.umi.txt	./macosko/1m_reads/kmer_7/reads_split/cell_CACTAATAATGG_reads.fastq.gz
cell_TCATGGGCTATT	./macosko/1m_reads/kmer_7/reads_split/cell_TCATGGGCTATT.umi.txt	./macosko/1m_reads/kmer_7/reads_split/cell_TCATGGGCTATT_reads.fastq.gz
cell_CGACACGGCTAA	./macosko/1m_reads/kmer_7/reads_split/cell_CGACACGGCTAA.umi.txt	./macosko/1m_reads/kmer_7/reads_split/cell_CGACACGGCTAA_reads.fastq.gz
cell_GATGCGACGGTC	./macosko/1m_reads/kmer_7/reads_split/cell_GATGCGACGGTC.umi.txt	./macosko/1m_reads/kmer_7/reads_split/cell_GATGCGACGGTC_reads.fastq.gz
cell_ATGTGGGACGTC	./macosko/1m_reads/kmer_7/reads_split/cell_ATGTGGGACGTC.umi.txt	./macosko/1m_reads/kmer_7/reads_split/cell_ATGTGGGACGTC_reads.fastq.gz
cell_ATGAGGCACAGA	./macosko/1m_reads/kmer_7/reads_split/cell_ATGAGGCACAGA.umi.txt	./macosko/1m_reads/kmer_7/reads_split/cell_ATGAGGCACAGA_reads.fastq.gz
cell_TCGTGTGCTTGC	./macosko/1m_reads/kmer_7/reads_split/cell_TCGTGTGCTTGC.umi.txt	./macosko/1m_reads/kmer_7/reads_split/cell_TCGTGTGCTTGC_reads.fastq.gz
cell_TAAGGTCGCCCA	./macosko/1m_reads/kmer_7/reads_split/cell_TAAGGTCGCCCA.umi.txt	./macosko/1m_reads/kmer_7/reads_split/cell_TAAGGTCGCCCA_reads.fastq.gz
cell_TTGCTACTGACG	./macosko/1m_reads/kmer_7/reads_split/cell_TTGCTACTGACG.umi.txt	./macosko/1m_reads/kmer_7/reads_split/cell_TTGCTACTGACG_reads.fastq.gz
cell_TCCTAGTGTGAT	./macosko/1m_reads/kmer_7/reads_split/cell_TCCTAGTGTGAT.umi.txt	./macosko/1m_reads/kmer_7/reads_split/cell_TCCTAGTGTGAT_reads.fastq.gz
cell_AGGTGCAGCGTT	./macosko/1m_reads/kmer_7/reads_split/cell_AGGTGCAGCGTT.umi.txt	./macosko/1m_reads/kmer_7/reads_split/cell_AGGTGCAGCGTT_reads.fastq.gz
cell_GGATGAGAGGTA	./macosko/1m_reads/kmer_7/reads_split/cell_GGATGAGAGGTA.umi.txt	./macosko/1m_reads/kmer_7/reads_split/cell_GGATGAGAGGTA_reads.fastq.gz
cell_ATGGGTCATCGC	./macosko/1m_reads/kmer_7/reads_split/cell_ATGGGTCATCGC.umi.txt	./macosko/1m_reads/kmer_7/reads_split/cell_ATGGGTCATCGC_reads.fastq.gz
cell_GTTAACGCAACG	./macosko/1m_reads/kmer_7/reads_split/cell_GTTAACGCAACG.umi.txt	./macosko/1m_reads/kmer_7/reads_split/cell_GTTAACGCAACG_reads.fastq.gz
cell_AAGCGATCGATA	./macosko/1m_reads/kmer_7/reads_split/cell_AAGCGATCGATA.umi.txt	./macosko/1m_reads/kmer_7/reads_split/cell_AAGCGATCGATA_reads.fastq.gz
cell_GTGTGACGTATT	./macosko/1m_reads/kmer_7/reads_split/cell_GTGTGACGTATT.umi.txt	./macosko/1m_reads/kmer_7/reads_split/cell_GTGTGACGTATT_reads.fastq.gz
cell_GTTTGTGCAAAC	./macosko/1m_reads/kmer_7/reads_split/cell_GTTTGTGCAAAC.umi.txt	./macosko/1m_reads/kmer_7/reads_split/cell_GTTTGTGCAAAC_reads.fastq.gz
cell_ACGACAGTATTC	./macosko/1m_reads/kmer_7/reads_split/cell_ACGACAGTATTC.umi.txt	./macosko/1m_reads/kmer_7/reads_split/cell_ACGACAGTATTC_reads.fastq.gz
cell_AGTCCGAGAGTG	./macosko/1m_reads/kmer_7/reads_split/cell_AGTCCGAGAGTG.umi.txt	./macosko/1m_reads/kmer_7/reads_split/cell_AGTCCGAGAGTG_reads.fastq.gz
cell_GATCACTATTTT	./macosko/1m_reads/kmer_7/reads_split/cell_GATCACTATTTT.umi.txt	./macosko/1m_reads/kmer_7/reads_split/cell_GATCACTATTTT_reads.fastq.gz
cell_ATAAGGCATTAC	./macosko/1m_reads/kmer_7/reads_split/cell_ATAAGGCATTAC.umi.txt	./macosko/1m_reads/kmer_7/reads_split/cell_ATAAGGCATTAC_reads.fastq.gz
cell_CGTCTATGTTTG	./macosko/1m_reads/kmer_7/reads_split/cell_CGTCTATGTTTG.umi.txt	./macosko/1m_reads/kmer_7/reads_split/cell_CGTCTATGTTTG_reads.fastq.gz
cell_CCGACGCGGCTA	./macosko/1m_reads/kmer_7/reads_split/cell_CCGACGCGGCTA.umi.txt	./macosko/1m_reads/kmer_7/reads_split/cell_CCGACGCGGCTA_reads.fastq.gz
cell_GTACAGGATTAG	./macosko/1m_reads/kmer_7/reads_split/cell_GTACAGGATTAG.umi.txt	./macosko/1m_reads/kmer_7/reads_split/cell_GTACAGGATTAG_reads.fastq.gz
cell_TCTCGCTGATCC	./macosko/1m_reads/kmer_7/reads_split/cell_TCTCGCTGATCC.umi.txt	./macosko/1m_reads/kmer_7/reads_split/cell_TCTCGCTGATCC_reads.fastq.gz
cell_GTGACATTGTTC	./macosko/1m_reads/kmer_7/reads_split/cell_GTGACATTGTTC.umi.txt	./macosko/1m_reads/kmer_7/reads_split/cell_GTGACATTGTTC_reads.fastq.gz
cell_GATCACATGGGT	./macosko/1m_reads/kmer_7/reads_split/cell_GATCACATGGGT.umi.txt	./macosko/1m_reads/kmer_7/reads_split/cell_GATCACATGGGT_reads.fastq.gz
cell_TTAGGTAACGTG	./macosko/1m_reads/kmer_7/reads_split/cell_TTAGGTAACGTG.umi.txt	./macosko/1m_reads/kmer_7/reads_split/cell_TTAGGTAACGTG_reads.fastq.gz
cell_CAACGCTGTCGG	./macosko/1m_reads/kmer_7/reads_split/cell_CAACGCTGTCGG.umi.txt	./macosko/1m_reads/kmer_7/reads_split/cell_CAACGCTGTCGG_reads.fastq.gz
cell_GGCTCGATGCAT	./macosko/1m_reads/kmer_7/reads_split/cell_GGCTCGATGCAT.umi.txt	./macosko/1m_reads/kmer_7/reads_split/cell_GGCTCGATGCAT_reads.fastq.gz
cell_ATTAATGAGAAT	./macosko/1m_reads/kmer_7/reads_split/cell_ATTAATGAGAAT.umi.txt	./macosko/1m_reads/kmer_7/reads_split/cell_ATTAATGAGAAT_reads.fastq.gz
cell_AAGGTTTCGGAA	./macosko/1m_reads/kmer_7/reads_split/cell_AAGGTTTCGGAA.umi.txt	./macosko/1m_reads/kmer_7/reads_split/cell_AAGGTTTCGGAA_reads.fastq.gz
cell_GATTCTTCGAAG	./macosko/1m_reads/kmer_7/reads_split/cell_GATTCTTCGAAG.umi.txt	./macosko/1m_reads/kmer_7/reads_split/cell_GATTCTTCGAAG_reads.fastq.gz
cell_GTGCTTCGCCAA	./macosko/1m_reads/kmer_7/reads_split/cell_GTGCTTCGCCAA.umi.txt	./macosko/1m_reads/kmer_7/reads_split/cell_GTGCTTCGCCAA_reads.fastq.gz
cell_GCATTCACTTAG	./macosko/1m_reads/kmer_7/reads_split/cell_GCATTCACTTAG.umi.txt	./macosko/1m_reads/kmer_7/reads_split/cell_GCATTCACTTAG_reads.fastq.gz
cell_GCCCATCCACGG	./macosko/1m_reads/kmer_7/reads_split/cell_GCCCATCCACGG.umi.txt	./macosko/1m_reads/kmer_7/reads_split/cell_GCCCATCCACGG_reads.fastq.gz
cell_GAAAGTATGCTT	./macosko/1m_reads/kmer_7/reads_split/cell_GAAAGTATGCTT.umi.txt	./macosko/1m_reads/kmer_7/reads_split/cell_GAAAGTATGCTT_reads.fastq.gz
cell_ACTTCATGACCC	./macosko/1m_reads/kmer_7/reads_split/cell_ACTTCATGACCC.umi.txt	./macosko/1m_reads/kmer_7/reads_split/cell_ACTTCATGACCC_reads.fastq.gz
cell_GTAGAGTCCATT	./macosko/1m_reads/kmer_7/reads_split/cell_GTAGAGTCCATT.umi.txt	./macosko/1m_reads/kmer_7/reads_split/cell_GTAGAGTCCATT_reads.fastq.gz
cell_TCTTCTAGTCGG	./macosko/1m_reads/kmer_7/reads_split/cell_TCTTCTAGTCGG.umi.txt	./macosko/1m_reads/kmer_7/reads_split/cell_TCTTCTAGTCGG_reads.fastq.gz
cell_CGAGTGTACCCA	./macosko/1m_reads/kmer_7/reads_split/cell_CGAGTGTACCCA.umi.txt	./macosko/1m_reads/kmer_7/reads_split/cell_CGAGTGTACCCA_reads.fastq.gz
cell_CCACTCCCCCCT	./macosko/1m_reads/kmer_7/reads_split/cell_CCACTCCCCCCT.umi.txt	./macosko/1m_reads/kmer_7/reads_split/cell_CCACTCCCCCCT_reads.fastq.gz
cell_ACAAGATCTCGC	./macosko/1m_reads/kmer_7/reads_split/cell_ACAAGATCTCGC.umi.txt	./macosko/1m_reads/kmer_7/reads_split/cell_ACAAGATCTCGC_reads.fastq.gz
cell_GTTCAACCCCGG	./macosko/1m_reads/kmer_7/reads_split/cell_GTTCAACCCCGG.umi.txt	./macosko/1m_reads/kmer_7/reads_split/cell_GTTCAACCCCGG_reads.fastq.gz
cell_AACTCCCTCTGT	./macosko/1m_reads/kmer_7/reads_split/cell_AACTCCCTCTGT.umi.txt	./macosko/1m_reads/kmer_7/reads_split/cell_AACTCCCTCTGT_reads.fastq.gz
cell_CTTAAACACCAG	./macosko/1m_reads/kmer_7/reads_split/cell_CTTAAACACCAG.umi.txt	./macosko/1m_reads/kmer_7/reads_split/cell_CTTAAACACCAG_reads.fastq.gz
cell_CTTGCCTGAATA	./macosko/1m_reads/kmer_7/reads_split/cell_CTTGCCTGAATA.umi.txt	./macosko/1m_reads/kmer_7/reads_split/cell_CTTGCCTGAATA_reads.fastq.gz
cell_GAAGAGTCGATG	./macosko/1m_reads/kmer_7/reads_split/cell_GAAGAGTCGATG.umi.txt	./macosko/1m_reads/kmer_7/reads_split/cell_GAAGAGTCGATG_reads.fastq.gz
cell_TACAAGCTAGGT	./macosko/1m_reads/kmer_7/reads_split/cell_TACAAGCTAGGT.umi.txt	./macosko/1m_reads/kmer_7/reads_split/cell_TACAAGCTAGGT_reads.fastq.gz
cell_GATCGCTCACTT	./macosko/1m_reads/kmer_7/reads_split/cell_GATCGCTCACTT.umi.txt	./macosko/1m_reads/kmer_7/reads_split/cell_GATCGCTCACTT_reads.fastq.gz
cell_GAATATAAGATA	./macosko/1m_reads/kmer_7/reads_split/cell_GAATATAAGATA.umi.txt	./macosko/1m_reads/kmer_7/reads_split/cell_GAATATAAGATA_reads.fastq.gz
cell_CGCGATACCACA	./macosko/1m_reads/kmer_7/reads_split/cell_CGCGATACCACA.umi.txt	./macosko/1m_reads/kmer_7/reads_split/cell_CGCGATACCACA_reads.fastq.gz
cell_AACTAGTCGCAG	./macosko/1m_reads/kmer_7/reads_split/cell_AACTAGTCGCAG.umi.txt	./macosko/1m_reads/kmer_7/reads_split/cell_AACTAGTCGCAG_reads.fastq.gz
cell_ACGGCCTCTATG	./macosko/1m_reads/kmer_7/reads_split/cell_ACGGCCTCTATG.umi.txt	./macosko/1m_reads/kmer_7/reads_split/cell_ACGGCCTCTATG_reads.fastq.gz
cell_ACAACAGCCCCT	./macosko/1m_reads/kmer_7/reads_split/cell_ACAACAGCCCCT.umi.txt	./macosko/1m_reads/kmer_7/reads_split/cell_ACAACAGCCCCT_reads.fastq.gz
cell_AGCACATCACTT	./macosko/1m_reads/kmer_7/reads_split/cell_AGCACATCACTT.umi.txt	./macosko/1m_reads/kmer_7/reads_split/cell_AGCACATCACTT_reads.fastq.gz
cell_GGAGCCTAGGCG	./macosko/1m_reads/kmer_7/reads_split/cell_GGAGCCTAGGCG.umi.txt	./macosko/1m_reads/kmer_7/reads_split/cell_GGAGCCTAGGCG_reads.fastq.gz
cell_AATCACGATCAA	./macosko/1m_reads/kmer_7/reads_split/cell_AATCACGATCAA.umi.txt	./macosko/1m_reads/kmer_7/reads_split/cell_AATCACGATCAA_reads.fastq.gz
cell_CCTGACGAGCAG	./macosko/1m_reads/kmer_7/reads_split/cell_CCTGACGAGCAG.umi.txt	./macosko/1m_reads/kmer_7/reads_split/cell_CCTGACGAGCAG_reads.fastq.gz
cell_GCTGTCCTGGGT	./macosko/1m_reads/kmer_7/reads_split/cell_GCTGTCCTGGGT.umi.txt	./macosko/1m_reads/kmer_7/reads_split/cell_GCTGTCCTGGGT_reads.fastq.gz
cell_ACTGAAGCTAAT	./macosko/1m_reads/kmer_7/reads_split/cell_ACTGAAGCTAAT.umi.txt	./macosko/1m_reads/kmer_7/reads_split/cell_ACTGAAGCTAAT_reads.fastq.gz
cell_GTACTTGTACCC	./macosko/1m_reads/kmer_7/reads_split/cell_GTACTTGTACCC.umi.txt	./macosko/1m_reads/kmer_7/reads_split/cell_GTACTTGTACCC_reads.fastq.gz
cell_CGGTAACTAAGC	./macosko/1m_reads/kmer_7/reads_split/cell_CGGTAACTAAGC.umi.txt	./macosko/1m_reads/kmer_7/reads_split/cell_CGGTAACTAAGC_reads.fastq.gz
cell_GGGCAATCCGCT	./macosko/1m_reads/kmer_7/reads_split/cell_GGGCAATCCGCT.umi.txt	./macosko/1m_reads/kmer_7/reads_split/cell_GGGCAATCCGCT_reads.fastq.gz
cell_CCCGCCTTGACC	./macosko/1m_reads/kmer_7/reads_split/cell_CCCGCCTTGACC.umi.txt	./macosko/1m_reads/kmer_7/reads_split/cell_CCCGCCTTGACC_reads.fastq.gz
cell_GGGAATAACGGC	./macosko/1m_reads/kmer_7/reads_split/cell_GGGAATAACGGC.umi.txt	./macosko/1m_reads/kmer_7/reads_split/cell_GGGAATAACGGC_reads.fastq.gz
cell_CCGGATACATAT	./macosko/1m_reads/kmer_7/reads_split/cell_CCGGATACATAT.umi.txt	./macosko/1m_reads/kmer_7/reads_split/cell_CCGGATACATAT_reads.fastq.gz
cell_GAGTACACGCCG	./macosko/1m_reads/kmer_7/reads_split/cell_GAGTACACGCCG.umi.txt	./macosko/1m_reads/kmer_7/reads_split/cell_GAGTACACGCCG_reads.fastq.gz
cell_CTGTCTCTTATA	./macosko/1m_reads/kmer_7/reads_split/cell_CTGTCTCTTATA.umi.txt	./macosko/1m_reads/kmer_7/reads_split/cell_CTGTCTCTTATA_reads.fastq.gz
cell_TGCTGTCCAGTC	./macosko/1m_reads/kmer_7/reads_split/cell_TGCTGTCCAGTC.umi.txt	./macosko/1m_reads/kmer_7/reads_split/cell_TGCTGTCCAGTC_reads.fastq.gz
cell_GATGCTAGGAGA	./macosko/1m_reads/kmer_7/reads_split/cell_GATGCTAGGAGA.umi.txt	./macosko/1m_reads/kmer_7/reads_split/cell_GATGCTAGGAGA_reads.fastq.gz
cell_GATATTTTTCGA	./macosko/1m_reads/kmer_7/reads_split/cell_GATATTTTTCGA.umi.txt	./macosko/1m_reads/kmer_7/reads_split/cell_GATATTTTTCGA_reads.fastq.gz
cell_GTGTACTCGGGA	./macosko/1m_reads/kmer_7/reads_split/cell_GTGTACTCGGGA.umi.txt	./macosko/1m_reads/kmer_7/reads_split/cell_GTGTACTCGGGA_reads.fastq.gz
cell_GGAGATACTGTC	./macosko/1m_reads/kmer_7/reads_split/cell_GGAGATACTGTC.umi.txt	./macosko/1m_reads/kmer_7/reads_split/cell_GGAGATACTGTC_reads.fastq.gz
cell_CGACAAATTGTT	./macosko/1m_reads/kmer_7/reads_split/cell_CGACAAATTGTT.umi.txt	./macosko/1m_reads/kmer_7/reads_split/cell_CGACAAATTGTT_reads.fastq.gz
cell_TGACTCATGATC	./macosko/1m_reads/kmer_7/reads_split/cell_TGACTCATGATC.umi.txt	./macosko/1m_reads/kmer_7/reads_split/cell_TGACTCATGATC_reads.fastq.gz
cell_TGTAACGCACGA	./macosko/1m_reads/kmer_7/reads_split/cell_TGTAACGCACGA.umi.txt	./macosko/1m_reads/kmer_7/reads_split/cell_TGTAACGCACGA_reads.fastq.gz
cell_TTCTACTATCTC	./macosko/1m_reads/kmer_7/reads_split/cell_TTCTACTATCTC.umi.txt	./macosko/1m_reads/kmer_7/reads_split/cell_TTCTACTATCTC_reads.fastq.gz
cell_GGTCGCTGTGTG	./macosko/1m_reads/kmer_7/reads_split/cell_GGTCGCTGTGTG.umi.txt	./macosko/1m_reads/kmer_7/reads_split/cell_GGTCGCTGTGTG_reads.fastq.gz
cell_CATAACCTAGTC	./macosko/1m_reads/kmer_7/reads_split/cell_CATAACCTAGTC.umi.txt	./macosko/1m_reads/kmer_7/reads_split/cell_CATAACCTAGTC_reads.fastq.gz
cell_TGCGTTCCACAT	./macosko/1m_reads/kmer_7/reads_split/cell_TGCGTTCCACAT.umi.txt	./macosko/1m_reads/kmer_7/reads_split/cell_TGCGTTCCACAT_reads.fastq.gz
cell_GGTTTCATATTT	./macosko/1m_reads/kmer_7/reads_split/cell_GGTTTCATATTT.umi.txt	./macosko/1m_reads/kmer_7/reads_split/cell_GGTTTCATATTT_reads.fastq.gz
cell_CCTTTAAATGCG	./macosko/1m_reads/kmer_7/reads_split/cell_CCTTTAAATGCG.umi.txt	./macosko/1m_reads/kmer_7/reads_split/cell_CCTTTAAATGCG_reads.fastq.gz
cell_GGATGCGTTCCC	./macosko/1m_reads/kmer_7/reads_split/cell_GGATGCGTTCCC.umi.txt	./macosko/1m_reads/kmer_7/reads_split/cell_GGATGCGTTCCC_reads.fastq.gz
cell_TGTGTGGGTTCC	./macosko/1m_reads/kmer_7/reads_split/cell_TGTGTGGGTTCC.umi.txt	./macosko/1m_reads/kmer_7/reads_split/cell_TGTGTGGGTTCC_reads.fastq.gz
cell_CCTATCAAGTAC	./macosko/1m_reads/kmer_7/reads_split/cell_CCTATCAAGTAC.umi.txt	./macosko/1m_reads/kmer_7/reads_split/cell_CCTATCAAGTAC_reads.fastq.gz
cell_GAGTAGAGGTGC	./macosko/1m_reads/kmer_7/reads_split/cell_GAGTAGAGGTGC.umi.txt	./macosko/1m_reads/kmer_7/reads_split/cell_GAGTAGAGGTGC_reads.fastq.gz
cell_GATCGTGTCTCC	./macosko/1m_reads/kmer_7/reads_split/cell_GATCGTGTCTCC.umi.txt	./macosko/1m_reads/kmer_7/reads_split/cell_GATCGTGTCTCC_reads.fastq.gz
cell_CGCTAGTCTCTC	./macosko/1m_reads/kmer_7/reads_split/cell_CGCTAGTCTCTC.umi.txt	./macosko/1m_reads/kmer_7/reads_split/cell_CGCTAGTCTCTC_reads.fastq.gz
cell_ATCGATCATAAG	./macosko/1m_reads/kmer_7/reads_split/cell_ATCGATCATAAG.umi.txt	./macosko/1m_reads/kmer_7/reads_split/cell_ATCGATCATAAG_reads.fastq.gz
cell_CAACACTGGCTC	./macosko/1m_reads/kmer_7/reads_split/cell_CAACACTGGCTC.umi.txt	./macosko/1m_reads/kmer_7/reads_split/cell_CAACACTGGCTC_reads.fastq.gz
cell_TACTGTGTGCAC	./macosko/1m_reads/kmer_7/reads_split/cell_TACTGTGTGCAC.umi.txt	./macosko/1m_reads/kmer_7/reads_split/cell_TACTGTGTGCAC_reads.fastq.gz
cell_ACCGTTTAAAAA	./macosko/1m_reads/kmer_7/reads_split/cell_ACCGTTTAAAAA.umi.txt	./macosko/1m_reads/kmer_7/reads_split/cell_ACCGTTTAAAAA_reads.fastq.gz
cell_ATGAAGACCATT	./macosko/1m_reads/kmer_7/reads_split/cell_ATGAAGACCATT.umi.txt	./macosko/1m_reads/kmer_7/reads_split/cell_ATGAAGACCATT_reads.fastq.gz
cell_ACCAGCTCGCAA	./macosko/1m_reads/kmer_7/reads_split/cell_ACCAGCTCGCAA.umi.txt	./macosko/1m_reads/kmer_7/reads_split/cell_ACCAGCTCGCAA_reads.fastq.gz
cell_CGTGTGGGTGCT	./macosko/1m_reads/kmer_7/reads_split/cell_CGTGTGGGTGCT.umi.txt	./macosko/1m_reads/kmer_7/reads_split/cell_CGTGTGGGTGCT_reads.fastq.gz
cell_AACCAAGGCCAT	./macosko/1m_reads/kmer_7/reads_split/cell_AACCAAGGCCAT.umi.txt	./macosko/1m_reads/kmer_7/reads_split/cell_AACCAAGGCCAT_reads.fastq.gz
cell_GGGCGATTCCGA	./macosko/1m_reads/kmer_7/reads_split/cell_GGGCGATTCCGA.umi.txt	./macosko/1m_reads/kmer_7/reads_split/cell_GGGCGATTCCGA_reads.fastq.gz
cell_GCTGATTTCAAG	./macosko/1m_reads/kmer_7/reads_split/cell_GCTGATTTCAAG.umi.txt	./macosko/1m_reads/kmer_7/reads_split/cell_GCTGATTTCAAG_reads.fastq.gz
cell_CCCTTCGTCTGC	./macosko/1m_reads/kmer_7/reads_split/cell_CCCTTCGTCTGC.umi.txt	./macosko/1m_reads/kmer_7/reads_split/cell_CCCTTCGTCTGC_reads.fastq.gz
cell_ACGAGCGCTTAA	./macosko/1m_reads/kmer_7/reads_split/cell_ACGAGCGCTTAA.umi.txt	./macosko/1m_reads/kmer_7/reads_split/cell_ACGAGCGCTTAA_reads.fastq.gz
cell_GCATGAAACTTC	./macosko/1m_reads/kmer_7/reads_split/cell_GCATGAAACTTC.umi.txt	./macosko/1m_reads/kmer_7/reads_split/cell_GCATGAAACTTC_reads.fastq.gz
cell_TTGGAGACGGTA	./macosko/1m_reads/kmer_7/reads_split/cell_TTGGAGACGGTA.umi.txt	./macosko/1m_reads/kmer_7/reads_split/cell_TTGGAGACGGTA_reads.fastq.gz
cell_TGAGAAAGTCTT	./macosko/1m_reads/kmer_7/reads_split/cell_TGAGAAAGTCTT.umi.txt	./macosko/1m_reads/kmer_7/reads_split/cell_TGAGAAAGTCTT_reads.fastq.gz
cell_ATATGACAGCAT	./macosko/1m_reads/kmer_7/reads_split/cell_ATATGACAGCAT.umi.txt	./macosko/1m_reads/kmer_7/reads_split/cell_ATATGACAGCAT_reads.fastq.gz
cell_AGGGAAGGGACC	./macosko/1m_reads/kmer_7/reads_split/cell_AGGGAAGGGACC.umi.txt	./macosko/1m_reads/kmer_7/reads_split/cell_AGGGAAGGGACC_reads.fastq.gz
cell_TTTTACGGTATT	./macosko/1m_reads/kmer_7/reads_split/cell_TTTTACGGTATT.umi.txt	./macosko/1m_reads/kmer_7/reads_split/cell_TTTTACGGTATT_reads.fastq.gz
cell_GGACAGGACGTA	./macosko/1m_reads/kmer_7/reads_split/cell_GGACAGGACGTA.umi.txt	./macosko/1m_reads/kmer_7/reads_split/cell_GGACAGGACGTA_reads.fastq.gz
cell_AGATTCTAAGCT	./macosko/1m_reads/kmer_7/reads_split/cell_AGATTCTAAGCT.umi.txt	./macosko/1m_reads/kmer_7/reads_split/cell_AGATTCTAAGCT_reads.fastq.gz
cell_CCCACGCGGAAG	./macosko/1m_reads/kmer_7/reads_split/cell_CCCACGCGGAAG.umi.txt	./macosko/1m_reads/kmer_7/reads_split/cell_CCCACGCGGAAG_reads.fastq.gz
cell_TGTCCGAGCGCA	./macosko/1m_reads/kmer_7/reads_split/cell_TGTCCGAGCGCA.umi.txt	./macosko/1m_reads/kmer_7/reads_split/cell_TGTCCGAGCGCA_reads.fastq.gz
cell_GCGATGTCGACG	./macosko/1m_reads/kmer_7/reads_split/cell_GCGATGTCGACG.umi.txt	./macosko/1m_reads/kmer_7/reads_split/cell_GCGATGTCGACG_reads.fastq.gz
cell_TTCCAAGGGACA	./macosko/1m_reads/kmer_7/reads_split/cell_TTCCAAGGGACA.umi.txt	./macosko/1m_reads/kmer_7/reads_split/cell_TTCCAAGGGACA_reads.fastq.gz
cell_GACAACTCATTA	./macosko/1m_reads/kmer_7/reads_split/cell_GACAACTCATTA.umi.txt	./macosko/1m_reads/kmer_7/reads_split/cell_GACAACTCATTA_reads.fastq.gz
cell_TGGCGCCGTATA	./macosko/1m_reads/kmer_7/reads_split/cell_TGGCGCCGTATA.umi.txt	./macosko/1m_reads/kmer_7/reads_split/cell_TGGCGCCGTATA_reads.fastq.gz
cell_GCTGCCTACGCT	./macosko/1m_reads/kmer_7/reads_split/cell_GCTGCCTACGCT.umi.txt	./macosko/1m_reads/kmer_7/reads_split/cell_GCTGCCTACGCT_reads.fastq.gz
cell_TTGAAGAGGAGC	./macosko/1m_reads/kmer_7/reads_split/cell_TTGAAGAGGAGC.umi.txt	./macosko/1m_reads/kmer_7/reads_split/cell_TTGAAGAGGAGC_reads.fastq.gz
cell_ATTTAGCAGACG	./macosko/1m_reads/kmer_7/reads_split/cell_ATTTAGCAGACG.umi.txt	./macosko/1m_reads/kmer_7/reads_split/cell_ATTTAGCAGACG_reads.fastq.gz
cell_TGTAAGTTATCT	./macosko/1m_reads/kmer_7/reads_split/cell_TGTAAGTTATCT.umi.txt	./macosko/1m_reads/kmer_7/reads_split/cell_TGTAAGTTATCT_reads.fastq.gz
cell_ATTTTCAAAAGA	./macosko/1m_reads/kmer_7/reads_split/cell_ATTTTCAAAAGA.umi.txt	./macosko/1m_reads/kmer_7/reads_split/cell_ATTTTCAAAAGA_reads.fastq.gz
cell_CCAACTTCAGAG	./macosko/1m_reads/kmer_7/reads_split/cell_CCAACTTCAGAG.umi.txt	./macosko/1m_reads/kmer_7/reads_split/cell_CCAACTTCAGAG_reads.fastq.gz
cell_TGGCGTTGCACC	./macosko/1m_reads/kmer_7/reads_split/cell_TGGCGTTGCACC.umi.txt	./macosko/1m_reads/kmer_7/reads_split/cell_TGGCGTTGCACC_reads.fastq.gz
cell_GGTCTTATGTTA	./macosko/1m_reads/kmer_7/reads_split/cell_GGTCTTATGTTA.umi.txt	./macosko/1m_reads/kmer_7/reads_split/cell_GGTCTTATGTTA_reads.fastq.gz
cell_GTGTGATAATCC	./macosko/1m_reads/kmer_7/reads_split/cell_GTGTGATAATCC.umi.txt	./macosko/1m_reads/kmer_7/reads_split/cell_GTGTGATAATCC_reads.fastq.gz
cell_ACCACACGTTTT	./macosko/1m_reads/kmer_7/reads_split/cell_ACCACACGTTTT.umi.txt	./macosko/1m_reads/kmer_7/reads_split/cell_ACCACACGTTTT_reads.fastq.gz
cell_CGCATGCGCCAA	./macosko/1m_reads/kmer_7/reads_split/cell_CGCATGCGCCAA.umi.txt	./macosko/1m_reads/kmer_7/reads_split/cell_CGCATGCGCCAA_reads.fastq.gz
cell_GATACAACGCCA	./macosko/1m_reads/kmer_7/reads_split/cell_GATACAACGCCA.umi.txt	./macosko/1m_reads/kmer_7/reads_split/cell_GATACAACGCCA_reads.fastq.gz
cell_CTGAGGCGGCCG	./macosko/1m_reads/kmer_7/reads_split/cell_CTGAGGCGGCCG.umi.txt	./macosko/1m_reads/kmer_7/reads_split/cell_CTGAGGCGGCCG_reads.fastq.gz
cell_ATTAGGAAGGTA	./macosko/1m_reads/kmer_7/reads_split/cell_ATTAGGAAGGTA.umi.txt	./macosko/1m_reads/kmer_7/reads_split/cell_ATTAGGAAGGTA_reads.fastq.gz
cell_AAGACTGCTTCC	./macosko/1m_reads/kmer_7/reads_split/cell_AAGACTGCTTCC.umi.txt	./macosko/1m_reads/kmer_7/reads_split/cell_AAGACTGCTTCC_reads.fastq.gz
cell_GTCGCATTCTTT	./macosko/1m_reads/kmer_7/reads_split/cell_GTCGCATTCTTT.umi.txt	./macosko/1m_reads/kmer_7/reads_split/cell_GTCGCATTCTTT_reads.fastq.gz
cell_CTGTAAATACAT	./macosko/1m_reads/kmer_7/reads_split/cell_CTGTAAATACAT.umi.txt	./macosko/1m_reads/kmer_7/reads_split/cell_CTGTAAATACAT_reads.fastq.gz
cell_AAGTGGGCATGA	./macosko/1m_reads/kmer_7/reads_split/cell_AAGTGGGCATGA.umi.txt	./macosko/1m_reads/kmer_7/reads_split/cell_AAGTGGGCATGA_reads.fastq.gz
cell_AACTCCTTGGTA	./macosko/1m_reads/kmer_7/reads_split/cell_AACTCCTTGGTA.umi.txt	./macosko/1m_reads/kmer_7/reads_split/cell_AACTCCTTGGTA_reads.fastq.gz
cell_AGCTATGTGCAG	./macosko/1m_reads/kmer_7/reads_split/cell_AGCTATGTGCAG.umi.txt	./macosko/1m_reads/kmer_7/reads_split/cell_AGCTATGTGCAG_reads.fastq.gz
cell_CGGCTGGTCCGC	./macosko/1m_reads/kmer_7/reads_split/cell_CGGCTGGTCCGC.umi.txt	./macosko/1m_reads/kmer_7/reads_split/cell_CGGCTGGTCCGC_reads.fastq.gz
cell_GGCAATGTGCCT	./macosko/1m_reads/kmer_7/reads_split/cell_GGCAATGTGCCT.umi.txt	./macosko/1m_reads/kmer_7/reads_split/cell_GGCAATGTGCCT_reads.fastq.gz
cell_CAGCATAGGCTG	./macosko/1m_reads/kmer_7/reads_split/cell_CAGCATAGGCTG.umi.txt	./macosko/1m_reads/kmer_7/reads_split/cell_CAGCATAGGCTG_reads.fastq.gz
cell_TCTCACTGATAG	./macosko/1m_reads/kmer_7/reads_split/cell_TCTCACTGATAG.umi.txt	./macosko/1m_reads/kmer_7/reads_split/cell_TCTCACTGATAG_reads.fastq.gz
cell_CTCGACGACAAG	./macosko/1m_reads/kmer_7/reads_split/cell_CTCGACGACAAG.umi.txt	./macosko/1m_reads/kmer_7/reads_split/cell_CTCGACGACAAG_reads.fastq.gz
cell_CGTGTTAGACAC	./macosko/1m_reads/kmer_7/reads_split/cell_CGTGTTAGACAC.umi.txt	./macosko/1m_reads/kmer_7/reads_split/cell_CGTGTTAGACAC_reads.fastq.gz
cell_TGCTAGGGATAT	./macosko/1m_reads/kmer_7/reads_split/cell_TGCTAGGGATAT.umi.txt	./macosko/1m_reads/kmer_7/reads_split/cell_TGCTAGGGATAT_reads.fastq.gz
cell_GGAGTCCCAGTA	./macosko/1m_reads/kmer_7/reads_split/cell_GGAGTCCCAGTA.umi.txt	./macosko/1m_reads/kmer_7/reads_split/cell_GGAGTCCCAGTA_reads.fastq.gz
cell_CCCCATTGGGGC	./macosko/1m_reads/kmer_7/reads_split/cell_CCCCATTGGGGC.umi.txt	./macosko/1m_reads/kmer_7/reads_split/cell_CCCCATTGGGGC_reads.fastq.gz
cell_GTTACTGTCGCT	./macosko/1m_reads/kmer_7/reads_split/cell_GTTACTGTCGCT.umi.txt	./macosko/1m_reads/kmer_7/reads_split/cell_GTTACTGTCGCT_reads.fastq.gz
cell_GTATAGAAATAC	./macosko/1m_reads/kmer_7/reads_split/cell_GTATAGAAATAC.umi.txt	./macosko/1m_reads/kmer_7/reads_split/cell_GTATAGAAATAC_reads.fastq.gz
cell_ATAGTATAGACC	./macosko/1m_reads/kmer_7/reads_split/cell_ATAGTATAGACC.umi.txt	./macosko/1m_reads/kmer_7/reads_split/cell_ATAGTATAGACC_reads.fastq.gz
cell_ATCTGAAGCCTT	./macosko/1m_reads/kmer_7/reads_split/cell_ATCTGAAGCCTT.umi.txt	./macosko/1m_reads/kmer_7/reads_split/cell_ATCTGAAGCCTT_reads.fastq.gz
cell_CGATATATGTGG	./macosko/1m_reads/kmer_7/reads_split/cell_CGATATATGTGG.umi.txt	./macosko/1m_reads/kmer_7/reads_split/cell_CGATATATGTGG_reads.fastq.gz
cell_GAAGGCGAAGAG	./macosko/1m_reads/kmer_7/reads_split/cell_GAAGGCGAAGAG.umi.txt	./macosko/1m_reads/kmer_7/reads_split/cell_GAAGGCGAAGAG_reads.fastq.gz
cell_CTGTAATTGTAC	./macosko/1m_reads/kmer_7/reads_split/cell_CTGTAATTGTAC.umi.txt	./macosko/1m_reads/kmer_7/reads_split/cell_CTGTAATTGTAC_reads.fastq.gz
cell_CGTTCGGAAGCG	./macosko/1m_reads/kmer_7/reads_split/cell_CGTTCGGAAGCG.umi.txt	./macosko/1m_reads/kmer_7/reads_split/cell_CGTTCGGAAGCG_reads.fastq.gz
cell_AATAACAGTAAG	./macosko/1m_reads/kmer_7/reads_split/cell_AATAACAGTAAG.umi.txt	./macosko/1m_reads/kmer_7/reads_split/cell_AATAACAGTAAG_reads.fastq.gz
cell_TGTTTCCATTGC	./macosko/1m_reads/kmer_7/reads_split/cell_TGTTTCCATTGC.umi.txt	./macosko/1m_reads/kmer_7/reads_split/cell_TGTTTCCATTGC_reads.fastq.gz
cell_TGGCCAAGTCTC	./macosko/1m_reads/kmer_7/reads_split/cell_TGGCCAAGTCTC.umi.txt	./macosko/1m_reads/kmer_7/reads_split/cell_TGGCCAAGTCTC_reads.fastq.gz
cell_CATACTATCGCC	./macosko/1m_reads/kmer_7/reads_split/cell_CATACTATCGCC.umi.txt	./macosko/1m_reads/kmer_7/reads_split/cell_CATACTATCGCC_reads.fastq.gz
cell_GAGTATGCGACC	./macosko/1m_reads/kmer_7/reads_split/cell_GAGTATGCGACC.umi.txt	./macosko/1m_reads/kmer_7/reads_split/cell_GAGTATGCGACC_reads.fastq.gz
cell_CGGAGTCAGGGC	./macosko/1m_reads/kmer_7/reads_split/cell_CGGAGTCAGGGC.umi.txt	./macosko/1m_reads/kmer_7/reads_split/cell_CGGAGTCAGGGC_reads.fastq.gz
cell_ACCTTCTCGAAC	./macosko/1m_reads/kmer_7/reads_split/cell_ACCTTCTCGAAC.umi.txt	./macosko/1m_reads/kmer_7/reads_split/cell_ACCTTCTCGAAC_reads.fastq.gz
cell_CCGTTGCCCGTA	./macosko/1m_reads/kmer_7/reads_split/cell_CCGTTGCCCGTA.umi.txt	./macosko/1m_reads/kmer_7/reads_split/cell_CCGTTGCCCGTA_reads.fastq.gz
cell_CAGGCGAACAGC	./macosko/1m_reads/kmer_7/reads_split/cell_CAGGCGAACAGC.umi.txt	./macosko/1m_reads/kmer_7/reads_split/cell_CAGGCGAACAGC_reads.fastq.gz
cell_CCTCCCCGTTGA	./macosko/1m_reads/kmer_7/reads_split/cell_CCTCCCCGTTGA.umi.txt	./macosko/1m_reads/kmer_7/reads_split/cell_CCTCCCCGTTGA_reads.fastq.gz
cell_TCAGTTACTGGA	./macosko/1m_reads/kmer_7/reads_split/cell_TCAGTTACTGGA.umi.txt	./macosko/1m_reads/kmer_7/reads_split/cell_TCAGTTACTGGA_reads.fastq.gz
cell_ACAACCTTCATA	./macosko/1m_reads/kmer_7/reads_split/cell_ACAACCTTCATA.umi.txt	./macosko/1m_reads/kmer_7/reads_split/cell_ACAACCTTCATA_reads.fastq.gz
cell_AGTCTATTCTGC	./macosko/1m_reads/kmer_7/reads_split/cell_AGTCTATTCTGC.umi.txt	./macosko/1m_reads/kmer_7/reads_split/cell_AGTCTATTCTGC_reads.fastq.gz
cell_TAACAGCGTGTA	./macosko/1m_reads/kmer_7/reads_split/cell_TAACAGCGTGTA.umi.txt	./macosko/1m_reads/kmer_7/reads_split/cell_TAACAGCGTGTA_reads.fastq.gz
cell_CTGGATGTTCAA	./macosko/1m_reads/kmer_7/reads_split/cell_CTGGATGTTCAA.umi.txt	./macosko/1m_reads/kmer_7/reads_split/cell_CTGGATGTTCAA_reads.fastq.gz
cell_ACGCGGCAGCCG	./macosko/1m_reads/kmer_7/reads_split/cell_ACGCGGCAGCCG.umi.txt	./macosko/1m_reads/kmer_7/reads_split/cell_ACGCGGCAGCCG_reads.fastq.gz
cell_AAGCGTTTATGG	./macosko/1m_reads/kmer_7/reads_split/cell_AAGCGTTTATGG.umi.txt	./macosko/1m_reads/kmer_7/reads_split/cell_AAGCGTTTATGG_reads.fastq.gz
cell_TTCTGTACGTCT	./macosko/1m_reads/kmer_7/reads_split/cell_TTCTGTACGTCT.umi.txt	./macosko/1m_reads/kmer_7/reads_split/cell_TTCTGTACGTCT_reads.fastq.gz
cell_CCCAGACACACT	./macosko/1m_reads/kmer_7/reads_split/cell_CCCAGACACACT.umi.txt	./macosko/1m_reads/kmer_7/reads_split/cell_CCCAGACACACT_reads.fastq.gz
cell_TTCGGGCCTGCT	./macosko/1m_reads/kmer_7/reads_split/cell_TTCGGGCCTGCT.umi.txt	./macosko/1m_reads/kmer_7/reads_split/cell_TTCGGGCCTGCT_reads.fastq.gz
cell_GAAAGATGTATA	./macosko/1m_reads/kmer_7/reads_split/cell_GAAAGATGTATA.umi.txt	./macosko/1m_reads/kmer_7/reads_split/cell_GAAAGATGTATA_reads.fastq.gz
cell_TTGGAGCACCTT	./macosko/1m_reads/kmer_7/reads_split/cell_TTGGAGCACCTT.umi.txt	./macosko/1m_reads/kmer_7/reads_split/cell_TTGGAGCACCTT_reads.fastq.gz
cell_TTGTATAGCGCA	./macosko/1m_reads/kmer_7/reads_split/cell_TTGTATAGCGCA.umi.txt	./macosko/1m_reads/kmer_7/reads_split/cell_TTGTATAGCGCA_reads.fastq.gz
cell_AGTTTATAGCAG	./macosko/1m_reads/kmer_7/reads_split/cell_AGTTTATAGCAG.umi.txt	./macosko/1m_reads/kmer_7/reads_split/cell_AGTTTATAGCAG_reads.fastq.gz
cell_CCTAATTGTCTC	./macosko/1m_reads/kmer_7/reads_split/cell_CCTAATTGTCTC.umi.txt	./macosko/1m_reads/kmer_7/reads_split/cell_CCTAATTGTCTC_reads.fastq.gz
cell_TAATCGGTGGCA	./macosko/1m_reads/kmer_7/reads_split/cell_TAATCGGTGGCA.umi.txt	./macosko/1m_reads/kmer_7/reads_split/cell_TAATCGGTGGCA_reads.fastq.gz
cell_GAGTCACTGCAA	./macosko/1m_reads/kmer_7/reads_split/cell_GAGTCACTGCAA.umi.txt	./macosko/1m_reads/kmer_7/reads_split/cell_GAGTCACTGCAA_reads.fastq.gz
cell_TGACGCTAAGGG	./macosko/1m_reads/kmer_7/reads_split/cell_TGACGCTAAGGG.umi.txt	./macosko/1m_reads/kmer_7/reads_split/cell_TGACGCTAAGGG_reads.fastq.gz
cell_GGTTTGAACCCA	./macosko/1m_reads/kmer_7/reads_split/cell_GGTTTGAACCCA.umi.txt	./macosko/1m_reads/kmer_7/reads_split/cell_GGTTTGAACCCA_reads.fastq.gz
cell_GCTATGAGGTCG	./macosko/1m_reads/kmer_7/reads_split/cell_GCTATGAGGTCG.umi.txt	./macosko/1m_reads/kmer_7/reads_split/cell_GCTATGAGGTCG_reads.fastq.gz
cell_TTTAATAGCTTT	./macosko/1m_reads/kmer_7/reads_split/cell_TTTAATAGCTTT.umi.txt	./macosko/1m_reads/kmer_7/reads_split/cell_TTTAATAGCTTT_reads.fastq.gz
cell_CAGTCAATGGCG	./macosko/1m_reads/kmer_7/reads_split/cell_CAGTCAATGGCG.umi.txt	./macosko/1m_reads/kmer_7/reads_split/cell_CAGTCAATGGCG_reads.fastq.gz
cell_TCACGCAGCTAC	./macosko/1m_reads/kmer_7/reads_split/cell_TCACGCAGCTAC.umi.txt	./macosko/1m_reads/kmer_7/reads_split/cell_TCACGCAGCTAC_reads.fastq.gz
cell_CCGACTGACGCC	./macosko/1m_reads/kmer_7/reads_split/cell_CCGACTGACGCC.umi.txt	./macosko/1m_reads/kmer_7/reads_split/cell_CCGACTGACGCC_reads.fastq.gz
cell_ATCCGGCTCGAC	./macosko/1m_reads/kmer_7/reads_split/cell_ATCCGGCTCGAC.umi.txt	./macosko/1m_reads/kmer_7/reads_split/cell_ATCCGGCTCGAC_reads.fastq.gz
cell_CCCGATGCAGCC	./macosko/1m_reads/kmer_7/reads_split/cell_CCCGATGCAGCC.umi.txt	./macosko/1m_reads/kmer_7/reads_split/cell_CCCGATGCAGCC_reads.fastq.gz
cell_CCTGTGGCTGGT	./macosko/1m_reads/kmer_7/reads_split/cell_CCTGTGGCTGGT.umi.txt	./macosko/1m_reads/kmer_7/reads_split/cell_CCTGTGGCTGGT_reads.fastq.gz
cell_TATGATGCTACT	./macosko/1m_reads/kmer_7/reads_split/cell_TATGATGCTACT.umi.txt	./macosko/1m_reads/kmer_7/reads_split/cell_TATGATGCTACT_reads.fastq.gz
cell_AGGCGTAGTTCC	./macosko/1m_reads/kmer_7/reads_split/cell_AGGCGTAGTTCC.umi.txt	./macosko/1m_reads/kmer_7/reads_split/cell_AGGCGTAGTTCC_reads.fastq.gz
cell_AATAGGTTGCGC	./macosko/1m_reads/kmer_7/reads_split/cell_AATAGGTTGCGC.umi.txt	./macosko/1m_reads/kmer_7/reads_split/cell_AATAGGTTGCGC_reads.fastq.gz
cell_CAGAACGCGCGG	./macosko/1m_reads/kmer_7/reads_split/cell_CAGAACGCGCGG.umi.txt	./macosko/1m_reads/kmer_7/reads_split/cell_CAGAACGCGCGG_reads.fastq.gz
cell_TAAAGACCACGC	./macosko/1m_reads/kmer_7/reads_split/cell_TAAAGACCACGC.umi.txt	./macosko/1m_reads/kmer_7/reads_split/cell_TAAAGACCACGC_reads.fastq.gz
cell_CGCACCTCGGAA	./macosko/1m_reads/kmer_7/reads_split/cell_CGCACCTCGGAA.umi.txt	./macosko/1m_reads/kmer_7/reads_split/cell_CGCACCTCGGAA_reads.fastq.gz
cell_AGTATTTCGCCA	./macosko/1m_reads/kmer_7/reads_split/cell_AGTATTTCGCCA.umi.txt	./macosko/1m_reads/kmer_7/reads_split/cell_AGTATTTCGCCA_reads.fastq.gz
cell_ATAACCAGACAA	./macosko/1m_reads/kmer_7/reads_split/cell_ATAACCAGACAA.umi.txt	./macosko/1m_reads/kmer_7/reads_split/cell_ATAACCAGACAA_reads.fastq.gz
cell_CTGAAAGCTACG	./macosko/1m_reads/kmer_7/reads_split/cell_CTGAAAGCTACG.umi.txt	./macosko/1m_reads/kmer_7/reads_split/cell_CTGAAAGCTACG_reads.fastq.gz
cell_AACCCTCTGTCA	./macosko/1m_reads/kmer_7/reads_split/cell_AACCCTCTGTCA.umi.txt	./macosko/1m_reads/kmer_7/reads_split/cell_AACCCTCTGTCA_reads.fastq.gz
cell_ACGCTGTAGGGT	./macosko/1m_reads/kmer_7/reads_split/cell_ACGCTGTAGGGT.umi.txt	./macosko/1m_reads/kmer_7/reads_split/cell_ACGCTGTAGGGT_reads.fastq.gz
cell_GCTTAAGTTTCC	./macosko/1m_reads/kmer_7/reads_split/cell_GCTTAAGTTTCC.umi.txt	./macosko/1m_reads/kmer_7/reads_split/cell_GCTTAAGTTTCC_reads.fastq.gz
cell_TCCACGCGAGTC	./macosko/1m_reads/kmer_7/reads_split/cell_TCCACGCGAGTC.umi.txt	./macosko/1m_reads/kmer_7/reads_split/cell_TCCACGCGAGTC_reads.fastq.gz
cell_GGAATGCTTGTT	./macosko/1m_reads/kmer_7/reads_split/cell_GGAATGCTTGTT.umi.txt	./macosko/1m_reads/kmer_7/reads_split/cell_GGAATGCTTGTT_reads.fastq.gz
cell_CCAGCCGAACGA	./macosko/1m_reads/kmer_7/reads_split/cell_CCAGCCGAACGA.umi.txt	./macosko/1m_reads/kmer_7/reads_split/cell_CCAGCCGAACGA_reads.fastq.gz
cell_AACCACGGGTAC	./macosko/1m_reads/kmer_7/reads_split/cell_AACCACGGGTAC.umi.txt	./macosko/1m_reads/kmer_7/reads_split/cell_AACCACGGGTAC_reads.fastq.gz
cell_TGCTATGAATAA	./macosko/1m_reads/kmer_7/reads_split/cell_TGCTATGAATAA.umi.txt	./macosko/1m_reads/kmer_7/reads_split/cell_TGCTATGAATAA_reads.fastq.gz
cell_TTCGCCTTATCG	./macosko/1m_reads/kmer_7/reads_split/cell_TTCGCCTTATCG.umi.txt	./macosko/1m_reads/kmer_7/reads_split/cell_TTCGCCTTATCG_reads.fastq.gz
cell_CACCCGAGCCTA	./macosko/1m_reads/kmer_7/reads_split/cell_CACCCGAGCCTA.umi.txt	./macosko/1m_reads/kmer_7/reads_split/cell_CACCCGAGCCTA_reads.fastq.gz
cell_CTCAACACGCAT	./macosko/1m_reads/kmer_7/reads_split/cell_CTCAACACGCAT.umi.txt	./macosko/1m_reads/kmer_7/reads_split/cell_CTCAACACGCAT_reads.fastq.gz
cell_TTACTTGACTGT	./macosko/1m_reads/kmer_7/reads_split/cell_TTACTTGACTGT.umi.txt	./macosko/1m_reads/kmer_7/reads_split/cell_TTACTTGACTGT_reads.fastq.gz
cell_ATATAGAAGTTC	./macosko/1m_reads/kmer_7/reads_split/cell_ATATAGAAGTTC.umi.txt	./macosko/1m_reads/kmer_7/reads_split/cell_ATATAGAAGTTC_reads.fastq.gz
cell_GCCAGTATGGAG	./macosko/1m_reads/kmer_7/reads_split/cell_GCCAGTATGGAG.umi.txt	./macosko/1m_reads/kmer_7/reads_split/cell_GCCAGTATGGAG_reads.fastq.gz
cell_GACGTCGGATTT	./macosko/1m_reads/kmer_7/reads_split/cell_GACGTCGGATTT.umi.txt	./macosko/1m_reads/kmer_7/reads_split/cell_GACGTCGGATTT_reads.fastq.gz
cell_ACACCGCGACAA	./macosko/1m_reads/kmer_7/reads_split/cell_ACACCGCGACAA.umi.txt	./macosko/1m_reads/kmer_7/reads_split/cell_ACACCGCGACAA_reads.fastq.gz
cell_TCAAAGCCCTAG	./macosko/1m_reads/kmer_7/reads_split/cell_TCAAAGCCCTAG.umi.txt	./macosko/1m_reads/kmer_7/reads_split/cell_TCAAAGCCCTAG_reads.fastq.gz
cell_GACGGAAGGAGC	./macosko/1m_reads/kmer_7/reads_split/cell_GACGGAAGGAGC.umi.txt	./macosko/1m_reads/kmer_7/reads_split/cell_GACGGAAGGAGC_reads.fastq.gz
cell_AAGTTGCGCGAG	./macosko/1m_reads/kmer_7/reads_split/cell_AAGTTGCGCGAG.umi.txt	./macosko/1m_reads/kmer_7/reads_split/cell_AAGTTGCGCGAG_reads.fastq.gz
cell_ATACAACATTAT	./macosko/1m_reads/kmer_7/reads_split/cell_ATACAACATTAT.umi.txt	./macosko/1m_reads/kmer_7/reads_split/cell_ATACAACATTAT_reads.fastq.gz
cell_CCGCGCTGGCTT	./macosko/1m_reads/kmer_7/reads_split/cell_CCGCGCTGGCTT.umi.txt	./macosko/1m_reads/kmer_7/reads_split/cell_CCGCGCTGGCTT_reads.fastq.gz
cell_GCCTATGACAGT	./macosko/1m_reads/kmer_7/reads_split/cell_GCCTATGACAGT.umi.txt	./macosko/1m_reads/kmer_7/reads_split/cell_GCCTATGACAGT_reads.fastq.gz
cell_CTCGCTGCCTCC	./macosko/1m_reads/kmer_7/reads_split/cell_CTCGCTGCCTCC.umi.txt	./macosko/1m_reads/kmer_7/reads_split/cell_CTCGCTGCCTCC_reads.fastq.gz
cell_CTCTCGGCTGAA	./macosko/1m_reads/kmer_7/reads_split/cell_CTCTCGGCTGAA.umi.txt	./macosko/1m_reads/kmer_7/reads_split/cell_CTCTCGGCTGAA_reads.fastq.gz
cell_TCGCATGCGTCG	./macosko/1m_reads/kmer_7/reads_split/cell_TCGCATGCGTCG.umi.txt	./macosko/1m_reads/kmer_7/reads_split/cell_TCGCATGCGTCG_reads.fastq.gz
cell_TTCCCCCTAGGA	./macosko/1m_reads/kmer_7/reads_split/cell_TTCCCCCTAGGA.umi.txt	./macosko/1m_reads/kmer_7/reads_split/cell_TTCCCCCTAGGA_reads.fastq.gz
cell_ACCACGAACGAC	./macosko/1m_reads/kmer_7/reads_split/cell_ACCACGAACGAC.umi.txt	./macosko/1m_reads/kmer_7/reads_split/cell_ACCACGAACGAC_reads.fastq.gz
cell_GCATGAAAACGG	./macosko/1m_reads/kmer_7/reads_split/cell_GCATGAAAACGG.umi.txt	./macosko/1m_reads/kmer_7/reads_split/cell_GCATGAAAACGG_reads.fastq.gz
cell_TATATTATAGAA	./macosko/1m_reads/kmer_7/reads_split/cell_TATATTATAGAA.umi.txt	./macosko/1m_reads/kmer_7/reads_split/cell_TATATTATAGAA_reads.fastq.gz
cell_TTCTTATCGTCA	./macosko/1m_reads/kmer_7/reads_split/cell_TTCTTATCGTCA.umi.txt	./macosko/1m_reads/kmer_7/reads_split/cell_TTCTTATCGTCA_reads.fastq.gz
cell_CTGGCTAGTCGC	./macosko/1m_reads/kmer_7/reads_split/cell_CTGGCTAGTCGC.umi.txt	./macosko/1m_reads/kmer_7/reads_split/cell_CTGGCTAGTCGC_reads.fastq.gz
cell_AGCGGAGCTTTA	./macosko/1m_reads/kmer_7/reads_split/cell_AGCGGAGCTTTA.umi.txt	./macosko/1m_reads/kmer_7/reads_split/cell_AGCGGAGCTTTA_reads.fastq.gz
cell_AAGCCCTTTTGG	./macosko/1m_reads/kmer_7/reads_split/cell_AAGCCCTTTTGG.umi.txt	./macosko/1m_reads/kmer_7/reads_split/cell_AAGCCCTTTTGG_reads.fastq.gz
cell_CACTGGAACCCT	./macosko/1m_reads/kmer_7/reads_split/cell_CACTGGAACCCT.umi.txt	./macosko/1m_reads/kmer_7/reads_split/cell_CACTGGAACCCT_reads.fastq.gz
cell_TCCAGCAGACGT	./macosko/1m_reads/kmer_7/reads_split/cell_TCCAGCAGACGT.umi.txt	./macosko/1m_reads/kmer_7/reads_split/cell_TCCAGCAGACGT_reads.fastq.gz
cell_TTCGAAACCATG	./macosko/1m_reads/kmer_7/reads_split/cell_TTCGAAACCATG.umi.txt	./macosko/1m_reads/kmer_7/reads_split/cell_TTCGAAACCATG_reads.fastq.gz
cell_CCTGATGACGAA	./macosko/1m_reads/kmer_7/reads_split/cell_CCTGATGACGAA.umi.txt	./macosko/1m_reads/kmer_7/reads_split/cell_CCTGATGACGAA_reads.fastq.gz
cell_CATCTACCTGCG	./macosko/1m_reads/kmer_7/reads_split/cell_CATCTACCTGCG.umi.txt	./macosko/1m_reads/kmer_7/reads_split/cell_CATCTACCTGCG_reads.fastq.gz
cell_GCAGTGGGAACA	./macosko/1m_reads/kmer_7/reads_split/cell_GCAGTGGGAACA.umi.txt	./macosko/1m_reads/kmer_7/reads_split/cell_GCAGTGGGAACA_reads.fastq.gz
cell_AACCGTCCACCT	./macosko/1m_reads/kmer_7/reads_split/cell_AACCGTCCACCT.umi.txt	./macosko/1m_reads/kmer_7/reads_split/cell_AACCGTCCACCT_reads.fastq.gz
cell_CTTCGTTAGGTT	./macosko/1m_reads/kmer_7/reads_split/cell_CTTCGTTAGGTT.umi.txt	./macosko/1m_reads/kmer_7/reads_split/cell_CTTCGTTAGGTT_reads.fastq.gz
cell_TGTCATTCGTAC	./macosko/1m_reads/kmer_7/reads_split/cell_TGTCATTCGTAC.umi.txt	./macosko/1m_reads/kmer_7/reads_split/cell_TGTCATTCGTAC_reads.fastq.gz
cell_GAAGCCCGGTGT	./macosko/1m_reads/kmer_7/reads_split/cell_GAAGCCCGGTGT.umi.txt	./macosko/1m_reads/kmer_7/reads_split/cell_GAAGCCCGGTGT_reads.fastq.gz
cell_AGTCACACCAAA	./macosko/1m_reads/kmer_7/reads_split/cell_AGTCACACCAAA.umi.txt	./macosko/1m_reads/kmer_7/reads_split/cell_AGTCACACCAAA_reads.fastq.gz
cell_TGTCCTGAGCCA	./macosko/1m_reads/kmer_7/reads_split/cell_TGTCCTGAGCCA.umi.txt	./macosko/1m_reads/kmer_7/reads_split/cell_TGTCCTGAGCCA_reads.fastq.gz
cell_GTGGCGCACGCT	./macosko/1m_reads/kmer_7/reads_split/cell_GTGGCGCACGCT.umi.txt	./macosko/1m_reads/kmer_7/reads_split/cell_GTGGCGCACGCT_reads.fastq.gz
cell_CTCGTAATGATG	./macosko/1m_reads/kmer_7/reads_split/cell_CTCGTAATGATG.umi.txt	./macosko/1m_reads/kmer_7/reads_split/cell_CTCGTAATGATG_reads.fastq.gz
cell_GCACTACTAACT	./macosko/1m_reads/kmer_7/reads_split/cell_GCACTACTAACT.umi.txt	./macosko/1m_reads/kmer_7/reads_split/cell_GCACTACTAACT_reads.fastq.gz
cell_GGTAACGTTCTG	./macosko/1m_reads/kmer_7/reads_split/cell_GGTAACGTTCTG.umi.txt	./macosko/1m_reads/kmer_7/reads_split/cell_GGTAACGTTCTG_reads.fastq.gz
cell_GGGGAGGAGTAG	./macosko/1m_reads/kmer_7/reads_split/cell_GGGGAGGAGTAG.umi.txt	./macosko/1m_reads/kmer_7/reads_split/cell_GGGGAGGAGTAG_reads.fastq.gz
cell_GGGACACTTCTC	./macosko/1m_reads/kmer_7/reads_split/cell_GGGACACTTCTC.umi.txt	./macosko/1m_reads/kmer_7/reads_split/cell_GGGACACTTCTC_reads.fastq.gz
cell_GCCCGCACTACC	./macosko/1m_reads/kmer_7/reads_split/cell_GCCCGCACTACC.umi.txt	./macosko/1m_reads/kmer_7/reads_split/cell_GCCCGCACTACC_reads.fastq.gz
cell_GTTCTCGTACAA	./macosko/1m_reads/kmer_7/reads_split/cell_GTTCTCGTACAA.umi.txt	./macosko/1m_reads/kmer_7/reads_split/cell_GTTCTCGTACAA_reads.fastq.gz
cell_AACAGCGAATGA	./macosko/1m_reads/kmer_7/reads_split/cell_AACAGCGAATGA.umi.txt	./macosko/1m_reads/kmer_7/reads_split/cell_AACAGCGAATGA_reads.fastq.gz
cell_ATAAGGTATCTT	./macosko/1m_reads/kmer_7/reads_split/cell_ATAAGGTATCTT.umi.txt	./macosko/1m_reads/kmer_7/reads_split/cell_ATAAGGTATCTT_reads.fastq.gz
cell_TTCGCGTGAACA	./macosko/1m_reads/kmer_7/reads_split/cell_TTCGCGTGAACA.umi.txt	./macosko/1m_reads/kmer_7/reads_split/cell_TTCGCGTGAACA_reads.fastq.gz
cell_TCCTTTTGTATA	./macosko/1m_reads/kmer_7/reads_split/cell_TCCTTTTGTATA.umi.txt	./macosko/1m_reads/kmer_7/reads_split/cell_TCCTTTTGTATA_reads.fastq.gz
cell_TTCCAAGAAACG	./macosko/1m_reads/kmer_7/reads_split/cell_TTCCAAGAAACG.umi.txt	./macosko/1m_reads/kmer_7/reads_split/cell_TTCCAAGAAACG_reads.fastq.gz
cell_GGGCAGAAAGGA	./macosko/1m_reads/kmer_7/reads_split/cell_GGGCAGAAAGGA.umi.txt	./macosko/1m_reads/kmer_7/reads_split/cell_GGGCAGAAAGGA_reads.fastq.gz
cell_TATCAACTGTGT	./macosko/1m_reads/kmer_7/reads_split/cell_TATCAACTGTGT.umi.txt	./macosko/1m_reads/kmer_7/reads_split/cell_TATCAACTGTGT_reads.fastq.gz
cell_CGTTTTACCTTG	./macosko/1m_reads/kmer_7/reads_split/cell_CGTTTTACCTTG.umi.txt	./macosko/1m_reads/kmer_7/reads_split/cell_CGTTTTACCTTG_reads.fastq.gz
cell_CACACCTGATGT	./macosko/1m_reads/kmer_7/reads_split/cell_CACACCTGATGT.umi.txt	./macosko/1m_reads/kmer_7/reads_split/cell_CACACCTGATGT_reads.fastq.gz
cell_TTTGGTAGCAAT	./macosko/1m_reads/kmer_7/reads_split/cell_TTTGGTAGCAAT.umi.txt	./macosko/1m_reads/kmer_7/reads_split/cell_TTTGGTAGCAAT_reads.fastq.gz
cell_TCAGCTCTTATT	./macosko/1m_reads/kmer_7/reads_split/cell_TCAGCTCTTATT.umi.txt	./macosko/1m_reads/kmer_7/reads_split/cell_TCAGCTCTTATT_reads.fastq.gz
cell_TTCCGCACTCAA	./macosko/1m_reads/kmer_7/reads_split/cell_TTCCGCACTCAA.umi.txt	./macosko/1m_reads/kmer_7/reads_split/cell_TTCCGCACTCAA_reads.fastq.gz
cell_AAAATGCTCACT	./macosko/1m_reads/kmer_7/reads_split/cell_AAAATGCTCACT.umi.txt	./macosko/1m_reads/kmer_7/reads_split/cell_AAAATGCTCACT_reads.fastq.gz
cell_CTGCAGCTAGAA	./macosko/1m_reads/kmer_7/reads_split/cell_CTGCAGCTAGAA.umi.txt	./macosko/1m_reads/kmer_7/reads_split/cell_CTGCAGCTAGAA_reads.fastq.gz
cell_AATCTGCTTTTC	./macosko/1m_reads/kmer_7/reads_split/cell_AATCTGCTTTTC.umi.txt	./macosko/1m_reads/kmer_7/reads_split/cell_AATCTGCTTTTC_reads.fastq.gz
cell_GGTTATCAAATT	./macosko/1m_reads/kmer_7/reads_split/cell_GGTTATCAAATT.umi.txt	./macosko/1m_reads/kmer_7/reads_split/cell_GGTTATCAAATT_reads.fastq.gz
cell_ATTTAGCTGCAC	./macosko/1m_reads/kmer_7/reads_split/cell_ATTTAGCTGCAC.umi.txt	./macosko/1m_reads/kmer_7/reads_split/cell_ATTTAGCTGCAC_reads.fastq.gz
cell_AATTGCTTCTCA	./macosko/1m_reads/kmer_7/reads_split/cell_AATTGCTTCTCA.umi.txt	./macosko/1m_reads/kmer_7/reads_split/cell_AATTGCTTCTCA_reads.fastq.gz
cell_CCGTCAGCTCTA	./macosko/1m_reads/kmer_7/reads_split/cell_CCGTCAGCTCTA.umi.txt	./macosko/1m_reads/kmer_7/reads_split/cell_CCGTCAGCTCTA_reads.fastq.gz
cell_GGAGGTGCCCTT	./macosko/1m_reads/kmer_7/reads_split/cell_GGAGGTGCCCTT.umi.txt	./macosko/1m_reads/kmer_7/reads_split/cell_GGAGGTGCCCTT_reads.fastq.gz
cell_GTCTGAGCACAT	./macosko/1m_reads/kmer_7/reads_split/cell_GTCTGAGCACAT.umi.txt	./macosko/1m_reads/kmer_7/reads_split/cell_GTCTGAGCACAT_reads.fastq.gz
cell_ATCCCTTTGAGC	./macosko/1m_reads/kmer_7/reads_split/cell_ATCCCTTTGAGC.umi.txt	./macosko/1m_reads/kmer_7/reads_split/cell_ATCCCTTTGAGC_reads.fastq.gz
cell_CAACAGCCCCTC	./macosko/1m_reads/kmer_7/reads_split/cell_CAACAGCCCCTC.umi.txt	./macosko/1m_reads/kmer_7/reads_split/cell_CAACAGCCCCTC_reads.fastq.gz
cell_TGCTGTTCTCGT	./macosko/1m_reads/kmer_7/reads_split/cell_TGCTGTTCTCGT.umi.txt	./macosko/1m_reads/kmer_7/reads_split/cell_TGCTGTTCTCGT_reads.fastq.gz
cell_TGACTATACTCG	./macosko/1m_reads/kmer_7/reads_split/cell_TGACTATACTCG.umi.txt	./macosko/1m_reads/kmer_7/reads_split/cell_TGACTATACTCG_reads.fastq.gz
cell_TCAATTAGAGGG	./macosko/1m_reads/kmer_7/reads_split/cell_TCAATTAGAGGG.umi.txt	./macosko/1m_reads/kmer_7/reads_split/cell_TCAATTAGAGGG_reads.fastq.gz
cell_GGAGATAATGGT	./macosko/1m_reads/kmer_7/reads_split/cell_GGAGATAATGGT.umi.txt	./macosko/1m_reads/kmer_7/reads_split/cell_GGAGATAATGGT_reads.fastq.gz
cell_TATAACATTGGC	./macosko/1m_reads/kmer_7/reads_split/cell_TATAACATTGGC.umi.txt	./macosko/1m_reads/kmer_7/reads_split/cell_TATAACATTGGC_reads.fastq.gz
cell_TAAAGAGAGAGA	./macosko/1m_reads/kmer_7/reads_split/cell_TAAAGAGAGAGA.umi.txt	./macosko/1m_reads/kmer_7/reads_split/cell_TAAAGAGAGAGA_reads.fastq.gz
cell_GAGCTCCTCCCA	./macosko/1m_reads/kmer_7/reads_split/cell_GAGCTCCTCCCA.umi.txt	./macosko/1m_reads/kmer_7/reads_split/cell_GAGCTCCTCCCA_reads.fastq.gz
cell_AGGTTAAGCACT	./macosko/1m_reads/kmer_7/reads_split/cell_AGGTTAAGCACT.umi.txt	./macosko/1m_reads/kmer_7/reads_split/cell_AGGTTAAGCACT_reads.fastq.gz
cell_TTGGTCGACGTT	./macosko/1m_reads/kmer_7/reads_split/cell_TTGGTCGACGTT.umi.txt	./macosko/1m_reads/kmer_7/reads_split/cell_TTGGTCGACGTT_reads.fastq.gz
cell_CCGTTCTACCGG	./macosko/1m_reads/kmer_7/reads_split/cell_CCGTTCTACCGG.umi.txt	./macosko/1m_reads/kmer_7/reads_split/cell_CCGTTCTACCGG_reads.fastq.gz
cell_TTAAGCGGCTTT	./macosko/1m_reads/kmer_7/reads_split/cell_TTAAGCGGCTTT.umi.txt	./macosko/1m_reads/kmer_7/reads_split/cell_TTAAGCGGCTTT_reads.fastq.gz
cell_AGACGCGTCGGG	./macosko/1m_reads/kmer_7/reads_split/cell_AGACGCGTCGGG.umi.txt	./macosko/1m_reads/kmer_7/reads_split/cell_AGACGCGTCGGG_reads.fastq.gz
cell_CTTGGTTTTCTA	./macosko/1m_reads/kmer_7/reads_split/cell_CTTGGTTTTCTA.umi.txt	./macosko/1m_reads/kmer_7/reads_split/cell_CTTGGTTTTCTA_reads.fastq.gz
cell_ATCCCTGCCGTC	./macosko/1m_reads/kmer_7/reads_split/cell_ATCCCTGCCGTC.umi.txt	./macosko/1m_reads/kmer_7/reads_split/cell_ATCCCTGCCGTC_reads.fastq.gz
cell_CTCCGGAATAAC	./macosko/1m_reads/kmer_7/reads_split/cell_CTCCGGAATAAC.umi.txt	./macosko/1m_reads/kmer_7/reads_split/cell_CTCCGGAATAAC_reads.fastq.gz
cell_GTGGAATCACTC	./macosko/1m_reads/kmer_7/reads_split/cell_GTGGAATCACTC.umi.txt	./macosko/1m_reads/kmer_7/reads_split/cell_GTGGAATCACTC_reads.fastq.gz
cell_ACGGCACGCGCT	./macosko/1m_reads/kmer_7/reads_split/cell_ACGGCACGCGCT.umi.txt	./macosko/1m_reads/kmer_7/reads_split/cell_ACGGCACGCGCT_reads.fastq.gz
cell_GGGTGGTAACGA	./macosko/1m_reads/kmer_7/reads_split/cell_GGGTGGTAACGA.umi.txt	./macosko/1m_reads/kmer_7/reads_split/cell_GGGTGGTAACGA_reads.fastq.gz
cell_AAGGTATATGGC	./macosko/1m_reads/kmer_7/reads_split/cell_AAGGTATATGGC.umi.txt	./macosko/1m_reads/kmer_7/reads_split/cell_AAGGTATATGGC_reads.fastq.gz
cell_CAGCCCAGAGAG	./macosko/1m_reads/kmer_7/reads_split/cell_CAGCCCAGAGAG.umi.txt	./macosko/1m_reads/kmer_7/reads_split/cell_CAGCCCAGAGAG_reads.fastq.gz
cell_GCTTAGAGAGAA	./macosko/1m_reads/kmer_7/reads_split/cell_GCTTAGAGAGAA.umi.txt	./macosko/1m_reads/kmer_7/reads_split/cell_GCTTAGAGAGAA_reads.fastq.gz
cell_CCTTGATTCACT	./macosko/1m_reads/kmer_7/reads_split/cell_CCTTGATTCACT.umi.txt	./macosko/1m_reads/kmer_7/reads_split/cell_CCTTGATTCACT_reads.fastq.gz
cell_ACTGAATTCTTG	./macosko/1m_reads/kmer_7/reads_split/cell_ACTGAATTCTTG.umi.txt	./macosko/1m_reads/kmer_7/reads_split/cell_ACTGAATTCTTG_reads.fastq.gz
cell_GAGTTTAATCTC	./macosko/1m_reads/kmer_7/reads_split/cell_GAGTTTAATCTC.umi.txt	./macosko/1m_reads/kmer_7/reads_split/cell_GAGTTTAATCTC_reads.fastq.gz
cell_CCAGTTTCCATC	./macosko/1m_reads/kmer_7/reads_split/cell_CCAGTTTCCATC.umi.txt	./macosko/1m_reads/kmer_7/reads_split/cell_CCAGTTTCCATC_reads.fastq.gz
cell_AGGGAGTACATG	./macosko/1m_reads/kmer_7/reads_split/cell_AGGGAGTACATG.umi.txt	./macosko/1m_reads/kmer_7/reads_split/cell_AGGGAGTACATG_reads.fastq.gz
cell_GGAGTTGCGGGG	./macosko/1m_reads/kmer_7/reads_split/cell_GGAGTTGCGGGG.umi.txt	./macosko/1m_reads/kmer_7/reads_split/cell_GGAGTTGCGGGG_reads.fastq.gz
cell_GTCTCGTGCACC	./macosko/1m_reads/kmer_7/reads_split/cell_GTCTCGTGCACC.umi.txt	./macosko/1m_reads/kmer_7/reads_split/cell_GTCTCGTGCACC_reads.fastq.gz
cell_CGAAGGTTGGCG	./macosko/1m_reads/kmer_7/reads_split/cell_CGAAGGTTGGCG.umi.txt	./macosko/1m_reads/kmer_7/reads_split/cell_CGAAGGTTGGCG_reads.fastq.gz
cell_CACGATTGTTAG	./macosko/1m_reads/kmer_7/reads_split/cell_CACGATTGTTAG.umi.txt	./macosko/1m_reads/kmer_7/reads_split/cell_CACGATTGTTAG_reads.fastq.gz
cell_AGTTCCATCCGC	./macosko/1m_reads/kmer_7/reads_split/cell_AGTTCCATCCGC.umi.txt	./macosko/1m_reads/kmer_7/reads_split/cell_AGTTCCATCCGC_reads.fastq.gz
cell_TGCGTAGATATG	./macosko/1m_reads/kmer_7/reads_split/cell_TGCGTAGATATG.umi.txt	./macosko/1m_reads/kmer_7/reads_split/cell_TGCGTAGATATG_reads.fastq.gz
cell_TCCCAAATATTT	./macosko/1m_reads/kmer_7/reads_split/cell_TCCCAAATATTT.umi.txt	./macosko/1m_reads/kmer_7/reads_split/cell_TCCCAAATATTT_reads.fastq.gz
cell_AATTGGAAGATT	./macosko/1m_reads/kmer_7/reads_split/cell_AATTGGAAGATT.umi.txt	./macosko/1m_reads/kmer_7/reads_split/cell_AATTGGAAGATT_reads.fastq.gz
cell_AACCTGTAGGTG	./macosko/1m_reads/kmer_7/reads_split/cell_AACCTGTAGGTG.umi.txt	./macosko/1m_reads/kmer_7/reads_split/cell_AACCTGTAGGTG_reads.fastq.gz
cell_TTTCCGAACTCA	./macosko/1m_reads/kmer_7/reads_split/cell_TTTCCGAACTCA.umi.txt	./macosko/1m_reads/kmer_7/reads_split/cell_TTTCCGAACTCA_reads.fastq.gz
cell_TATTTGTTACTG	./macosko/1m_reads/kmer_7/reads_split/cell_TATTTGTTACTG.umi.txt	./macosko/1m_reads/kmer_7/reads_split/cell_TATTTGTTACTG_reads.fastq.gz
cell_AACGCGTGATGT	./macosko/1m_reads/kmer_7/reads_split/cell_AACGCGTGATGT.umi.txt	./macosko/1m_reads/kmer_7/reads_split/cell_AACGCGTGATGT_reads.fastq.gz
cell_TACGGCGTCACT	./macosko/1m_reads/kmer_7/reads_split/cell_TACGGCGTCACT.umi.txt	./macosko/1m_reads/kmer_7/reads_split/cell_TACGGCGTCACT_reads.fastq.gz
cell_ACCGGCCCCGGT	./macosko/1m_reads/kmer_7/reads_split/cell_ACCGGCCCCGGT.umi.txt	./macosko/1m_reads/kmer_7/reads_split/cell_ACCGGCCCCGGT_reads.fastq.gz
cell_CGTACTGACTAC	./macosko/1m_reads/kmer_7/reads_split/cell_CGTACTGACTAC.umi.txt	./macosko/1m_reads/kmer_7/reads_split/cell_CGTACTGACTAC_reads.fastq.gz
cell_GGGCTCGATGCG	./macosko/1m_reads/kmer_7/reads_split/cell_GGGCTCGATGCG.umi.txt	./macosko/1m_reads/kmer_7/reads_split/cell_GGGCTCGATGCG_reads.fastq.gz
cell_AGAGTTGTTCGG	./macosko/1m_reads/kmer_7/reads_split/cell_AGAGTTGTTCGG.umi.txt	./macosko/1m_reads/kmer_7/reads_split/cell_AGAGTTGTTCGG_reads.fastq.gz
cell_CGTAGGTAGGCC	./macosko/1m_reads/kmer_7/reads_split/cell_CGTAGGTAGGCC.umi.txt	./macosko/1m_reads/kmer_7/reads_split/cell_CGTAGGTAGGCC_reads.fastq.gz
cell_TGACTAGGTGGG	./macosko/1m_reads/kmer_7/reads_split/cell_TGACTAGGTGGG.umi.txt	./macosko/1m_reads/kmer_7/reads_split/cell_TGACTAGGTGGG_reads.fastq.gz
cell_GACGCACCTGAG	./macosko/1m_reads/kmer_7/reads_split/cell_GACGCACCTGAG.umi.txt	./macosko/1m_reads/kmer_7/reads_split/cell_GACGCACCTGAG_reads.fastq.gz
cell_GGCCCGATTGCA	./macosko/1m_reads/kmer_7/reads_split/cell_GGCCCGATTGCA.umi.txt	./macosko/1m_reads/kmer_7/reads_split/cell_GGCCCGATTGCA_reads.fastq.gz
cell_AGACCAACTCAA	./macosko/1m_reads/kmer_7/reads_split/cell_AGACCAACTCAA.umi.txt	./macosko/1m_reads/kmer_7/reads_split/cell_AGACCAACTCAA_reads.fastq.gz
cell_AACTGGCTAAAC	./macosko/1m_reads/kmer_7/reads_split/cell_AACTGGCTAAAC.umi.txt	./macosko/1m_reads/kmer_7/reads_split/cell_AACTGGCTAAAC_reads.fastq.gz
cell_CAATGGATGTGC	./macosko/1m_reads/kmer_7/reads_split/cell_CAATGGATGTGC.umi.txt	./macosko/1m_reads/kmer_7/reads_split/cell_CAATGGATGTGC_reads.fastq.gz
cell_TGGGACTACGGG	./macosko/1m_reads/kmer_7/reads_split/cell_TGGGACTACGGG.umi.txt	./macosko/1m_reads/kmer_7/reads_split/cell_TGGGACTACGGG_reads.fastq.gz
cell_TCCCACGCTGAA	./macosko/1m_reads/kmer_7/reads_split/cell_TCCCACGCTGAA.umi.txt	./macosko/1m_reads/kmer_7/reads_split/cell_TCCCACGCTGAA_reads.fastq.gz
cell_GTACGAATACCT	./macosko/1m_reads/kmer_7/reads_split/cell_GTACGAATACCT.umi.txt	./macosko/1m_reads/kmer_7/reads_split/cell_GTACGAATACCT_reads.fastq.gz
cell_AGAGCATAGCGC	./macosko/1m_reads/kmer_7/reads_split/cell_AGAGCATAGCGC.umi.txt	./macosko/1m_reads/kmer_7/reads_split/cell_AGAGCATAGCGC_reads.fastq.gz
cell_CCTGTCTCTTAT	./macosko/1m_reads/kmer_7/reads_split/cell_CCTGTCTCTTAT.umi.txt	./macosko/1m_reads/kmer_7/reads_split/cell_CCTGTCTCTTAT_reads.fastq.gz
cell_TGGTTCGAGTGC	./macosko/1m_reads/kmer_7/reads_split/cell_TGGTTCGAGTGC.umi.txt	./macosko/1m_reads/kmer_7/reads_split/cell_TGGTTCGAGTGC_reads.fastq.gz
cell_ATCCTAGCCTGT	./macosko/1m_reads/kmer_7/reads_split/cell_ATCCTAGCCTGT.umi.txt	./macosko/1m_reads/kmer_7/reads_split/cell_ATCCTAGCCTGT_reads.fastq.gz
cell_TGTCTCTTATAC	./macosko/1m_reads/kmer_7/reads_split/cell_TGTCTCTTATAC.umi.txt	./macosko/1m_reads/kmer_7/reads_split/cell_TGTCTCTTATAC_reads.fastq.gz
cell_AACCCGGGACCG	./macosko/1m_reads/kmer_7/reads_split/cell_AACCCGGGACCG.umi.txt	./macosko/1m_reads/kmer_7/reads_split/cell_AACCCGGGACCG_reads.fastq.gz
cell_TCTCTCCCCTTG	./macosko/1m_reads/kmer_7/reads_split/cell_TCTCTCCCCTTG.umi.txt	./macosko/1m_reads/kmer_7/reads_split/cell_TCTCTCCCCTTG_reads.fastq.gz
cell_TCGCGAGAAAAT	./macosko/1m_reads/kmer_7/reads_split/cell_TCGCGAGAAAAT.umi.txt	./macosko/1m_reads/kmer_7/reads_split/cell_TCGCGAGAAAAT_reads.fastq.gz
