cell_TCAACACTAAAC	example/reads_split/cell_TCAACACTAAAC.umi.txt	example/reads_split/cell_TCAACACTAAAC_reads.fastq.gz
cell_GCTAGTTGTGCT	example/reads_split/cell_GCTAGTTGTGCT.umi.txt	example/reads_split/cell_GCTAGTTGTGCT_reads.fastq.gz
cell_AAACCACCGGCA	example/reads_split/cell_AAACCACCGGCA.umi.txt	example/reads_split/cell_AAACCACCGGCA_reads.fastq.gz
cell_GTCATATCCAAT	example/reads_split/cell_GTCATATCCAAT.umi.txt	example/reads_split/cell_GTCATATCCAAT_reads.fastq.gz
cell_TCCAAAATAGAA	example/reads_split/cell_TCCAAAATAGAA.umi.txt	example/reads_split/cell_TCCAAAATAGAA_reads.fastq.gz
cell_AGGAGATTGTGC	example/reads_split/cell_AGGAGATTGTGC.umi.txt	example/reads_split/cell_AGGAGATTGTGC_reads.fastq.gz
cell_AGACGATGAAGG	example/reads_split/cell_AGACGATGAAGG.umi.txt	example/reads_split/cell_AGACGATGAAGG_reads.fastq.gz
cell_GGCCCACTTTAA	example/reads_split/cell_GGCCCACTTTAA.umi.txt	example/reads_split/cell_GGCCCACTTTAA_reads.fastq.gz
cell_ACTAAGTAAGAT	example/reads_split/cell_ACTAAGTAAGAT.umi.txt	example/reads_split/cell_ACTAAGTAAGAT_reads.fastq.gz
cell_TCGTCAATTGTC	example/reads_split/cell_TCGTCAATTGTC.umi.txt	example/reads_split/cell_TCGTCAATTGTC_reads.fastq.gz
cell_CCGTCGGACACC	example/reads_split/cell_CCGTCGGACACC.umi.txt	example/reads_split/cell_CCGTCGGACACC_reads.fastq.gz
cell_CCTATTGTGGGA	example/reads_split/cell_CCTATTGTGGGA.umi.txt	example/reads_split/cell_CCTATTGTGGGA_reads.fastq.gz
cell_ACTTGCCGGAAT	example/reads_split/cell_ACTTGCCGGAAT.umi.txt	example/reads_split/cell_ACTTGCCGGAAT_reads.fastq.gz
cell_TTAGGTCTCCTT	example/reads_split/cell_TTAGGTCTCCTT.umi.txt	example/reads_split/cell_TTAGGTCTCCTT_reads.fastq.gz
cell_GTTCGTCCCGCC	example/reads_split/cell_GTTCGTCCCGCC.umi.txt	example/reads_split/cell_GTTCGTCCCGCC_reads.fastq.gz
cell_TACTGATCATAT	example/reads_split/cell_TACTGATCATAT.umi.txt	example/reads_split/cell_TACTGATCATAT_reads.fastq.gz
cell_AGGTGTTGTCGA	example/reads_split/cell_AGGTGTTGTCGA.umi.txt	example/reads_split/cell_AGGTGTTGTCGA_reads.fastq.gz
cell_TTCTCGTCTAAG	example/reads_split/cell_TTCTCGTCTAAG.umi.txt	example/reads_split/cell_TTCTCGTCTAAG_reads.fastq.gz
cell_CCCATACCATTT	example/reads_split/cell_CCCATACCATTT.umi.txt	example/reads_split/cell_CCCATACCATTT_reads.fastq.gz
cell_CAAGCCACGCCG	example/reads_split/cell_CAAGCCACGCCG.umi.txt	example/reads_split/cell_CAAGCCACGCCG_reads.fastq.gz
cell_AGAGACTACCCC	example/reads_split/cell_AGAGACTACCCC.umi.txt	example/reads_split/cell_AGAGACTACCCC_reads.fastq.gz
cell_TCCTAGGACCCG	example/reads_split/cell_TCCTAGGACCCG.umi.txt	example/reads_split/cell_TCCTAGGACCCG_reads.fastq.gz
cell_TAATCTAGTCTC	example/reads_split/cell_TAATCTAGTCTC.umi.txt	example/reads_split/cell_TAATCTAGTCTC_reads.fastq.gz
cell_CGTCCCGGCATC	example/reads_split/cell_CGTCCCGGCATC.umi.txt	example/reads_split/cell_CGTCCCGGCATC_reads.fastq.gz
cell_ATCGGAAAAGCC	example/reads_split/cell_ATCGGAAAAGCC.umi.txt	example/reads_split/cell_ATCGGAAAAGCC_reads.fastq.gz
cell_CGCCGTGGCGCC	example/reads_split/cell_CGCCGTGGCGCC.umi.txt	example/reads_split/cell_CGCCGTGGCGCC_reads.fastq.gz
cell_AGGCTTCCCTTA	example/reads_split/cell_AGGCTTCCCTTA.umi.txt	example/reads_split/cell_AGGCTTCCCTTA_reads.fastq.gz
cell_TGTGTGCAAGAT	example/reads_split/cell_TGTGTGCAAGAT.umi.txt	example/reads_split/cell_TGTGTGCAAGAT_reads.fastq.gz
cell_CATCAAAAGGTA	example/reads_split/cell_CATCAAAAGGTA.umi.txt	example/reads_split/cell_CATCAAAAGGTA_reads.fastq.gz
cell_AGCAAATTTTGT	example/reads_split/cell_AGCAAATTTTGT.umi.txt	example/reads_split/cell_AGCAAATTTTGT_reads.fastq.gz
cell_TCAAGGCGTGTG	example/reads_split/cell_TCAAGGCGTGTG.umi.txt	example/reads_split/cell_TCAAGGCGTGTG_reads.fastq.gz
cell_ATACTCTTCACG	example/reads_split/cell_ATACTCTTCACG.umi.txt	example/reads_split/cell_ATACTCTTCACG_reads.fastq.gz
cell_ATAGTCTGTCTC	example/reads_split/cell_ATAGTCTGTCTC.umi.txt	example/reads_split/cell_ATAGTCTGTCTC_reads.fastq.gz
cell_AGCCGTCGATGA	example/reads_split/cell_AGCCGTCGATGA.umi.txt	example/reads_split/cell_AGCCGTCGATGA_reads.fastq.gz
cell_GGCAACTATCAA	example/reads_split/cell_GGCAACTATCAA.umi.txt	example/reads_split/cell_GGCAACTATCAA_reads.fastq.gz
cell_CACCGGCGACGT	example/reads_split/cell_CACCGGCGACGT.umi.txt	example/reads_split/cell_CACCGGCGACGT_reads.fastq.gz
cell_GAACTCATCGCT	example/reads_split/cell_GAACTCATCGCT.umi.txt	example/reads_split/cell_GAACTCATCGCT_reads.fastq.gz
cell_TGATGGAATAGA	example/reads_split/cell_TGATGGAATAGA.umi.txt	example/reads_split/cell_TGATGGAATAGA_reads.fastq.gz
cell_CAAACCTCGAAT	example/reads_split/cell_CAAACCTCGAAT.umi.txt	example/reads_split/cell_CAAACCTCGAAT_reads.fastq.gz
cell_TTCACGTCTTTC	example/reads_split/cell_TTCACGTCTTTC.umi.txt	example/reads_split/cell_TTCACGTCTTTC_reads.fastq.gz
cell_AAATTGGTGCAA	example/reads_split/cell_AAATTGGTGCAA.umi.txt	example/reads_split/cell_AAATTGGTGCAA_reads.fastq.gz
cell_AAACCCCCTGTC	example/reads_split/cell_AAACCCCCTGTC.umi.txt	example/reads_split/cell_AAACCCCCTGTC_reads.fastq.gz
cell_GCGCGCTCACAC	example/reads_split/cell_GCGCGCTCACAC.umi.txt	example/reads_split/cell_GCGCGCTCACAC_reads.fastq.gz
cell_AACTCACGACTC	example/reads_split/cell_AACTCACGACTC.umi.txt	example/reads_split/cell_AACTCACGACTC_reads.fastq.gz
cell_TGGAAATCAGGA	example/reads_split/cell_TGGAAATCAGGA.umi.txt	example/reads_split/cell_TGGAAATCAGGA_reads.fastq.gz
cell_TTCCAAAGTGGC	example/reads_split/cell_TTCCAAAGTGGC.umi.txt	example/reads_split/cell_TTCCAAAGTGGC_reads.fastq.gz
cell_TTCGGCGAGATC	example/reads_split/cell_TTCGGCGAGATC.umi.txt	example/reads_split/cell_TTCGGCGAGATC_reads.fastq.gz
cell_ACTCAGTAGATA	example/reads_split/cell_ACTCAGTAGATA.umi.txt	example/reads_split/cell_ACTCAGTAGATA_reads.fastq.gz
cell_AGTCCGGATAAC	example/reads_split/cell_AGTCCGGATAAC.umi.txt	example/reads_split/cell_AGTCCGGATAAC_reads.fastq.gz
cell_TATATGGTCGGA	example/reads_split/cell_TATATGGTCGGA.umi.txt	example/reads_split/cell_TATATGGTCGGA_reads.fastq.gz
cell_GAGTACCGAACA	example/reads_split/cell_GAGTACCGAACA.umi.txt	example/reads_split/cell_GAGTACCGAACA_reads.fastq.gz
cell_CCCAGGCTAGGG	example/reads_split/cell_CCCAGGCTAGGG.umi.txt	example/reads_split/cell_CCCAGGCTAGGG_reads.fastq.gz
cell_CGTATGAAGGTC	example/reads_split/cell_CGTATGAAGGTC.umi.txt	example/reads_split/cell_CGTATGAAGGTC_reads.fastq.gz
cell_TTGGGAAACAAG	example/reads_split/cell_TTGGGAAACAAG.umi.txt	example/reads_split/cell_TTGGGAAACAAG_reads.fastq.gz
cell_CGTCAAAATCAA	example/reads_split/cell_CGTCAAAATCAA.umi.txt	example/reads_split/cell_CGTCAAAATCAA_reads.fastq.gz
cell_TACTCTACAATC	example/reads_split/cell_TACTCTACAATC.umi.txt	example/reads_split/cell_TACTCTACAATC_reads.fastq.gz
cell_GCTGTGTGGCGA	example/reads_split/cell_GCTGTGTGGCGA.umi.txt	example/reads_split/cell_GCTGTGTGGCGA_reads.fastq.gz
cell_TGTTGTGTGGCA	example/reads_split/cell_TGTTGTGTGGCA.umi.txt	example/reads_split/cell_TGTTGTGTGGCA_reads.fastq.gz
cell_TTTTAGCTGATA	example/reads_split/cell_TTTTAGCTGATA.umi.txt	example/reads_split/cell_TTTTAGCTGATA_reads.fastq.gz
cell_GACTTATTGCTG	example/reads_split/cell_GACTTATTGCTG.umi.txt	example/reads_split/cell_GACTTATTGCTG_reads.fastq.gz
cell_GGTTGGAGTTGC	example/reads_split/cell_GGTTGGAGTTGC.umi.txt	example/reads_split/cell_GGTTGGAGTTGC_reads.fastq.gz
cell_CTAGGCTCACTG	example/reads_split/cell_CTAGGCTCACTG.umi.txt	example/reads_split/cell_CTAGGCTCACTG_reads.fastq.gz
cell_ATTATAACAAGG	example/reads_split/cell_ATTATAACAAGG.umi.txt	example/reads_split/cell_ATTATAACAAGG_reads.fastq.gz
cell_ATAAGTCCTTTA	example/reads_split/cell_ATAAGTCCTTTA.umi.txt	example/reads_split/cell_ATAAGTCCTTTA_reads.fastq.gz
cell_AGTGGGGATGGG	example/reads_split/cell_AGTGGGGATGGG.umi.txt	example/reads_split/cell_AGTGGGGATGGG_reads.fastq.gz
cell_ATTACGATTACA	example/reads_split/cell_ATTACGATTACA.umi.txt	example/reads_split/cell_ATTACGATTACA_reads.fastq.gz
cell_TGTCTTGATAAT	example/reads_split/cell_TGTCTTGATAAT.umi.txt	example/reads_split/cell_TGTCTTGATAAT_reads.fastq.gz
cell_GGGAATTGTAAA	example/reads_split/cell_GGGAATTGTAAA.umi.txt	example/reads_split/cell_GGGAATTGTAAA_reads.fastq.gz
cell_GTCTTACATGCC	example/reads_split/cell_GTCTTACATGCC.umi.txt	example/reads_split/cell_GTCTTACATGCC_reads.fastq.gz
cell_TGTGGTTGAACG	example/reads_split/cell_TGTGGTTGAACG.umi.txt	example/reads_split/cell_TGTGGTTGAACG_reads.fastq.gz
cell_ATATCACCCTGC	example/reads_split/cell_ATATCACCCTGC.umi.txt	example/reads_split/cell_ATATCACCCTGC_reads.fastq.gz
cell_TTAGCTTGCCGA	example/reads_split/cell_TTAGCTTGCCGA.umi.txt	example/reads_split/cell_TTAGCTTGCCGA_reads.fastq.gz
cell_ATCAGTTTACCG	example/reads_split/cell_ATCAGTTTACCG.umi.txt	example/reads_split/cell_ATCAGTTTACCG_reads.fastq.gz
cell_CCCTGGTCCGCA	example/reads_split/cell_CCCTGGTCCGCA.umi.txt	example/reads_split/cell_CCCTGGTCCGCA_reads.fastq.gz
cell_GCTACGTACCCA	example/reads_split/cell_GCTACGTACCCA.umi.txt	example/reads_split/cell_GCTACGTACCCA_reads.fastq.gz
cell_CTTACCCGGATG	example/reads_split/cell_CTTACCCGGATG.umi.txt	example/reads_split/cell_CTTACCCGGATG_reads.fastq.gz
cell_CAGCCCGTTTTT	example/reads_split/cell_CAGCCCGTTTTT.umi.txt	example/reads_split/cell_CAGCCCGTTTTT_reads.fastq.gz
cell_CCATGTGATGTC	example/reads_split/cell_CCATGTGATGTC.umi.txt	example/reads_split/cell_CCATGTGATGTC_reads.fastq.gz
cell_TGGGCCGAAGCC	example/reads_split/cell_TGGGCCGAAGCC.umi.txt	example/reads_split/cell_TGGGCCGAAGCC_reads.fastq.gz
cell_GCGACCAGGAAT	example/reads_split/cell_GCGACCAGGAAT.umi.txt	example/reads_split/cell_GCGACCAGGAAT_reads.fastq.gz
cell_AGTACTCCTAGG	example/reads_split/cell_AGTACTCCTAGG.umi.txt	example/reads_split/cell_AGTACTCCTAGG_reads.fastq.gz
cell_ATCATAGGTAAG	example/reads_split/cell_ATCATAGGTAAG.umi.txt	example/reads_split/cell_ATCATAGGTAAG_reads.fastq.gz
cell_GGCAGACTCCGA	example/reads_split/cell_GGCAGACTCCGA.umi.txt	example/reads_split/cell_GGCAGACTCCGA_reads.fastq.gz
cell_ACATACGGTTAG	example/reads_split/cell_ACATACGGTTAG.umi.txt	example/reads_split/cell_ACATACGGTTAG_reads.fastq.gz
cell_ACCCTGTCTCTT	example/reads_split/cell_ACCCTGTCTCTT.umi.txt	example/reads_split/cell_ACCCTGTCTCTT_reads.fastq.gz
cell_AATATTCAACGC	example/reads_split/cell_AATATTCAACGC.umi.txt	example/reads_split/cell_AATATTCAACGC_reads.fastq.gz
cell_TTTGTGAGGGTC	example/reads_split/cell_TTTGTGAGGGTC.umi.txt	example/reads_split/cell_TTTGTGAGGGTC_reads.fastq.gz
cell_GGCGATGGTCAA	example/reads_split/cell_GGCGATGGTCAA.umi.txt	example/reads_split/cell_GGCGATGGTCAA_reads.fastq.gz
cell_CGGTGACTCCTA	example/reads_split/cell_CGGTGACTCCTA.umi.txt	example/reads_split/cell_CGGTGACTCCTA_reads.fastq.gz
cell_TCTTAATTAATA	example/reads_split/cell_TCTTAATTAATA.umi.txt	example/reads_split/cell_TCTTAATTAATA_reads.fastq.gz
cell_AACGCATAACAA	example/reads_split/cell_AACGCATAACAA.umi.txt	example/reads_split/cell_AACGCATAACAA_reads.fastq.gz
cell_TAGCCACGACAT	example/reads_split/cell_TAGCCACGACAT.umi.txt	example/reads_split/cell_TAGCCACGACAT_reads.fastq.gz
cell_TGATTGATAGAT	example/reads_split/cell_TGATTGATAGAT.umi.txt	example/reads_split/cell_TGATTGATAGAT_reads.fastq.gz
cell_CAGTCAATCTAA	example/reads_split/cell_CAGTCAATCTAA.umi.txt	example/reads_split/cell_CAGTCAATCTAA_reads.fastq.gz
cell_CTATTAGGCGTT	example/reads_split/cell_CTATTAGGCGTT.umi.txt	example/reads_split/cell_CTATTAGGCGTT_reads.fastq.gz
cell_GGTTGGCATGGT	example/reads_split/cell_GGTTGGCATGGT.umi.txt	example/reads_split/cell_GGTTGGCATGGT_reads.fastq.gz
cell_AATTGATGGACA	example/reads_split/cell_AATTGATGGACA.umi.txt	example/reads_split/cell_AATTGATGGACA_reads.fastq.gz
cell_TAGGAAATGACG	example/reads_split/cell_TAGGAAATGACG.umi.txt	example/reads_split/cell_TAGGAAATGACG_reads.fastq.gz
cell_CAGCCACTGCTC	example/reads_split/cell_CAGCCACTGCTC.umi.txt	example/reads_split/cell_CAGCCACTGCTC_reads.fastq.gz
cell_AAGTGTGGAGCA	example/reads_split/cell_AAGTGTGGAGCA.umi.txt	example/reads_split/cell_AAGTGTGGAGCA_reads.fastq.gz
cell_TCATCGATTATG	example/reads_split/cell_TCATCGATTATG.umi.txt	example/reads_split/cell_TCATCGATTATG_reads.fastq.gz
cell_TACTACCGGAGA	example/reads_split/cell_TACTACCGGAGA.umi.txt	example/reads_split/cell_TACTACCGGAGA_reads.fastq.gz
cell_AATGTGCCACCC	example/reads_split/cell_AATGTGCCACCC.umi.txt	example/reads_split/cell_AATGTGCCACCC_reads.fastq.gz
cell_ATCTTTACTCGA	example/reads_split/cell_ATCTTTACTCGA.umi.txt	example/reads_split/cell_ATCTTTACTCGA_reads.fastq.gz
cell_GAATTGCCAGAC	example/reads_split/cell_GAATTGCCAGAC.umi.txt	example/reads_split/cell_GAATTGCCAGAC_reads.fastq.gz
cell_TGTTATTCCGTC	example/reads_split/cell_TGTTATTCCGTC.umi.txt	example/reads_split/cell_TGTTATTCCGTC_reads.fastq.gz
cell_TTCACCGCCCCC	example/reads_split/cell_TTCACCGCCCCC.umi.txt	example/reads_split/cell_TTCACCGCCCCC_reads.fastq.gz
cell_GACGTGTGGACA	example/reads_split/cell_GACGTGTGGACA.umi.txt	example/reads_split/cell_GACGTGTGGACA_reads.fastq.gz
cell_GGGTAGGTACCC	example/reads_split/cell_GGGTAGGTACCC.umi.txt	example/reads_split/cell_GGGTAGGTACCC_reads.fastq.gz
cell_CCAGCATACTGC	example/reads_split/cell_CCAGCATACTGC.umi.txt	example/reads_split/cell_CCAGCATACTGC_reads.fastq.gz
cell_ATAAAAACATTA	example/reads_split/cell_ATAAAAACATTA.umi.txt	example/reads_split/cell_ATAAAAACATTA_reads.fastq.gz
cell_CCCGAAGCGCGG	example/reads_split/cell_CCCGAAGCGCGG.umi.txt	example/reads_split/cell_CCCGAAGCGCGG_reads.fastq.gz
cell_GCAGAGTCGTTC	example/reads_split/cell_GCAGAGTCGTTC.umi.txt	example/reads_split/cell_GCAGAGTCGTTC_reads.fastq.gz
cell_GCGATGCGATCC	example/reads_split/cell_GCGATGCGATCC.umi.txt	example/reads_split/cell_GCGATGCGATCC_reads.fastq.gz
cell_TTGTCTAAGTCC	example/reads_split/cell_TTGTCTAAGTCC.umi.txt	example/reads_split/cell_TTGTCTAAGTCC_reads.fastq.gz
cell_CGATATTTTCGA	example/reads_split/cell_CGATATTTTCGA.umi.txt	example/reads_split/cell_CGATATTTTCGA_reads.fastq.gz
cell_ACCTCAGTACGC	example/reads_split/cell_ACCTCAGTACGC.umi.txt	example/reads_split/cell_ACCTCAGTACGC_reads.fastq.gz
cell_ATCCTCCTCATC	example/reads_split/cell_ATCCTCCTCATC.umi.txt	example/reads_split/cell_ATCCTCCTCATC_reads.fastq.gz
cell_CTAAAGGCCGCA	example/reads_split/cell_CTAAAGGCCGCA.umi.txt	example/reads_split/cell_CTAAAGGCCGCA_reads.fastq.gz
cell_CCAATGCAAGCG	example/reads_split/cell_CCAATGCAAGCG.umi.txt	example/reads_split/cell_CCAATGCAAGCG_reads.fastq.gz
cell_AGCTCGGCCCCC	example/reads_split/cell_AGCTCGGCCCCC.umi.txt	example/reads_split/cell_AGCTCGGCCCCC_reads.fastq.gz
cell_ATGCACAGGGTA	example/reads_split/cell_ATGCACAGGGTA.umi.txt	example/reads_split/cell_ATGCACAGGGTA_reads.fastq.gz
cell_TTACGTGGAGGC	example/reads_split/cell_TTACGTGGAGGC.umi.txt	example/reads_split/cell_TTACGTGGAGGC_reads.fastq.gz
cell_CGAGGCAAGTGA	example/reads_split/cell_CGAGGCAAGTGA.umi.txt	example/reads_split/cell_CGAGGCAAGTGA_reads.fastq.gz
cell_ACCTAAGTTGCT	example/reads_split/cell_ACCTAAGTTGCT.umi.txt	example/reads_split/cell_ACCTAAGTTGCT_reads.fastq.gz
cell_CCTTTCAACGTT	example/reads_split/cell_CCTTTCAACGTT.umi.txt	example/reads_split/cell_CCTTTCAACGTT_reads.fastq.gz
cell_GCTGTCGGAAGG	example/reads_split/cell_GCTGTCGGAAGG.umi.txt	example/reads_split/cell_GCTGTCGGAAGG_reads.fastq.gz
cell_CCGGTCGTGCTG	example/reads_split/cell_CCGGTCGTGCTG.umi.txt	example/reads_split/cell_CCGGTCGTGCTG_reads.fastq.gz
cell_GCCGAATGGCTG	example/reads_split/cell_GCCGAATGGCTG.umi.txt	example/reads_split/cell_GCCGAATGGCTG_reads.fastq.gz
cell_TACTCGTTATGA	example/reads_split/cell_TACTCGTTATGA.umi.txt	example/reads_split/cell_TACTCGTTATGA_reads.fastq.gz
cell_AGCTCTAAGTCG	example/reads_split/cell_AGCTCTAAGTCG.umi.txt	example/reads_split/cell_AGCTCTAAGTCG_reads.fastq.gz
cell_CATCTCAGGTAA	example/reads_split/cell_CATCTCAGGTAA.umi.txt	example/reads_split/cell_CATCTCAGGTAA_reads.fastq.gz
cell_CACCAGGTTGAA	example/reads_split/cell_CACCAGGTTGAA.umi.txt	example/reads_split/cell_CACCAGGTTGAA_reads.fastq.gz
cell_CCTTTAGTAAAC	example/reads_split/cell_CCTTTAGTAAAC.umi.txt	example/reads_split/cell_CCTTTAGTAAAC_reads.fastq.gz
cell_TCGACCCCTTCA	example/reads_split/cell_TCGACCCCTTCA.umi.txt	example/reads_split/cell_TCGACCCCTTCA_reads.fastq.gz
cell_TAACCCCTAGCC	example/reads_split/cell_TAACCCCTAGCC.umi.txt	example/reads_split/cell_TAACCCCTAGCC_reads.fastq.gz
cell_AATCCCTTAGAG	example/reads_split/cell_AATCCCTTAGAG.umi.txt	example/reads_split/cell_AATCCCTTAGAG_reads.fastq.gz
cell_AGTTCGTTTAGC	example/reads_split/cell_AGTTCGTTTAGC.umi.txt	example/reads_split/cell_AGTTCGTTTAGC_reads.fastq.gz
cell_GAGTTAAAGGCC	example/reads_split/cell_GAGTTAAAGGCC.umi.txt	example/reads_split/cell_GAGTTAAAGGCC_reads.fastq.gz
cell_GAAAATGCTAGT	example/reads_split/cell_GAAAATGCTAGT.umi.txt	example/reads_split/cell_GAAAATGCTAGT_reads.fastq.gz
cell_AGCTACCTTGGC	example/reads_split/cell_AGCTACCTTGGC.umi.txt	example/reads_split/cell_AGCTACCTTGGC_reads.fastq.gz
cell_CAAAAAACGTTG	example/reads_split/cell_CAAAAAACGTTG.umi.txt	example/reads_split/cell_CAAAAAACGTTG_reads.fastq.gz
cell_GTTATCCCTAGC	example/reads_split/cell_GTTATCCCTAGC.umi.txt	example/reads_split/cell_GTTATCCCTAGC_reads.fastq.gz
cell_GTGAGCGTTATA	example/reads_split/cell_GTGAGCGTTATA.umi.txt	example/reads_split/cell_GTGAGCGTTATA_reads.fastq.gz
cell_CACCTGTCAACA	example/reads_split/cell_CACCTGTCAACA.umi.txt	example/reads_split/cell_CACCTGTCAACA_reads.fastq.gz
cell_ACTAATCCAGCC	example/reads_split/cell_ACTAATCCAGCC.umi.txt	example/reads_split/cell_ACTAATCCAGCC_reads.fastq.gz
cell_CCTTGCCTCGTC	example/reads_split/cell_CCTTGCCTCGTC.umi.txt	example/reads_split/cell_CCTTGCCTCGTC_reads.fastq.gz
cell_GAACGGAAGCAC	example/reads_split/cell_GAACGGAAGCAC.umi.txt	example/reads_split/cell_GAACGGAAGCAC_reads.fastq.gz
cell_GTAAGCTTGTAT	example/reads_split/cell_GTAAGCTTGTAT.umi.txt	example/reads_split/cell_GTAAGCTTGTAT_reads.fastq.gz
cell_GTATCTTACGCA	example/reads_split/cell_GTATCTTACGCA.umi.txt	example/reads_split/cell_GTATCTTACGCA_reads.fastq.gz
cell_GACAGGCTACCA	example/reads_split/cell_GACAGGCTACCA.umi.txt	example/reads_split/cell_GACAGGCTACCA_reads.fastq.gz
cell_ATCGTAGGGAGC	example/reads_split/cell_ATCGTAGGGAGC.umi.txt	example/reads_split/cell_ATCGTAGGGAGC_reads.fastq.gz
cell_TACCGACGCGCT	example/reads_split/cell_TACCGACGCGCT.umi.txt	example/reads_split/cell_TACCGACGCGCT_reads.fastq.gz
cell_AAAAAAAAAAAA	example/reads_split/cell_AAAAAAAAAAAA.umi.txt	example/reads_split/cell_AAAAAAAAAAAA_reads.fastq.gz
cell_TGATAAGGACAC	example/reads_split/cell_TGATAAGGACAC.umi.txt	example/reads_split/cell_TGATAAGGACAC_reads.fastq.gz
cell_CAGGGTTTGCAC	example/reads_split/cell_CAGGGTTTGCAC.umi.txt	example/reads_split/cell_CAGGGTTTGCAC_reads.fastq.gz
cell_CACTTCTAAGCA	example/reads_split/cell_CACTTCTAAGCA.umi.txt	example/reads_split/cell_CACTTCTAAGCA_reads.fastq.gz
cell_GACGGCTATTCC	example/reads_split/cell_GACGGCTATTCC.umi.txt	example/reads_split/cell_GACGGCTATTCC_reads.fastq.gz
cell_CTCGGCTGTGTT	example/reads_split/cell_CTCGGCTGTGTT.umi.txt	example/reads_split/cell_CTCGGCTGTGTT_reads.fastq.gz
cell_CCTTGGATATAT	example/reads_split/cell_CCTTGGATATAT.umi.txt	example/reads_split/cell_CCTTGGATATAT_reads.fastq.gz
cell_TTACCAGCGCCA	example/reads_split/cell_TTACCAGCGCCA.umi.txt	example/reads_split/cell_TTACCAGCGCCA_reads.fastq.gz
cell_CAGCGGATCGTC	example/reads_split/cell_CAGCGGATCGTC.umi.txt	example/reads_split/cell_CAGCGGATCGTC_reads.fastq.gz
cell_ATTCGTAGCGAC	example/reads_split/cell_ATTCGTAGCGAC.umi.txt	example/reads_split/cell_ATTCGTAGCGAC_reads.fastq.gz
cell_ACGCAATTTAGA	example/reads_split/cell_ACGCAATTTAGA.umi.txt	example/reads_split/cell_ACGCAATTTAGA_reads.fastq.gz
cell_AGTACACGTGAT	example/reads_split/cell_AGTACACGTGAT.umi.txt	example/reads_split/cell_AGTACACGTGAT_reads.fastq.gz
cell_TTGACTAGTACT	example/reads_split/cell_TTGACTAGTACT.umi.txt	example/reads_split/cell_TTGACTAGTACT_reads.fastq.gz
cell_TGGCGTCGAGCT	example/reads_split/cell_TGGCGTCGAGCT.umi.txt	example/reads_split/cell_TGGCGTCGAGCT_reads.fastq.gz
cell_TCCGCAGCAGAA	example/reads_split/cell_TCCGCAGCAGAA.umi.txt	example/reads_split/cell_TCCGCAGCAGAA_reads.fastq.gz
cell_CCTTTGAACAGG	example/reads_split/cell_CCTTTGAACAGG.umi.txt	example/reads_split/cell_CCTTTGAACAGG_reads.fastq.gz
cell_TTGACGCCACTG	example/reads_split/cell_TTGACGCCACTG.umi.txt	example/reads_split/cell_TTGACGCCACTG_reads.fastq.gz
cell_TCGGAGGCTATT	example/reads_split/cell_TCGGAGGCTATT.umi.txt	example/reads_split/cell_TCGGAGGCTATT_reads.fastq.gz
cell_CCCTTGACGTAA	example/reads_split/cell_CCCTTGACGTAA.umi.txt	example/reads_split/cell_CCCTTGACGTAA_reads.fastq.gz
cell_CCCAAGCGCCTG	example/reads_split/cell_CCCAAGCGCCTG.umi.txt	example/reads_split/cell_CCCAAGCGCCTG_reads.fastq.gz
cell_GGTGCGAGGTCT	example/reads_split/cell_GGTGCGAGGTCT.umi.txt	example/reads_split/cell_GGTGCGAGGTCT_reads.fastq.gz
cell_CTTCGACCTCAT	example/reads_split/cell_CTTCGACCTCAT.umi.txt	example/reads_split/cell_CTTCGACCTCAT_reads.fastq.gz
cell_GTGTCGCCTTGG	example/reads_split/cell_GTGTCGCCTTGG.umi.txt	example/reads_split/cell_GTGTCGCCTTGG_reads.fastq.gz
cell_ATTCAACTTCGA	example/reads_split/cell_ATTCAACTTCGA.umi.txt	example/reads_split/cell_ATTCAACTTCGA_reads.fastq.gz
cell_TGGTGACACAGG	example/reads_split/cell_TGGTGACACAGG.umi.txt	example/reads_split/cell_TGGTGACACAGG_reads.fastq.gz
cell_TCACCCCTGTTT	example/reads_split/cell_TCACCCCTGTTT.umi.txt	example/reads_split/cell_TCACCCCTGTTT_reads.fastq.gz
cell_GCCAACTGGGCC	example/reads_split/cell_GCCAACTGGGCC.umi.txt	example/reads_split/cell_GCCAACTGGGCC_reads.fastq.gz
cell_ACGGGATGGGCC	example/reads_split/cell_ACGGGATGGGCC.umi.txt	example/reads_split/cell_ACGGGATGGGCC_reads.fastq.gz
cell_CCATTAGATGGT	example/reads_split/cell_CCATTAGATGGT.umi.txt	example/reads_split/cell_CCATTAGATGGT_reads.fastq.gz
cell_TTCCTCGTCTGA	example/reads_split/cell_TTCCTCGTCTGA.umi.txt	example/reads_split/cell_TTCCTCGTCTGA_reads.fastq.gz
cell_ACTTCTGATTAT	example/reads_split/cell_ACTTCTGATTAT.umi.txt	example/reads_split/cell_ACTTCTGATTAT_reads.fastq.gz
cell_TTGGCCCGTCTC	example/reads_split/cell_TTGGCCCGTCTC.umi.txt	example/reads_split/cell_TTGGCCCGTCTC_reads.fastq.gz
cell_ATAGCTGTCTCT	example/reads_split/cell_ATAGCTGTCTCT.umi.txt	example/reads_split/cell_ATAGCTGTCTCT_reads.fastq.gz
cell_GTACAACGATAC	example/reads_split/cell_GTACAACGATAC.umi.txt	example/reads_split/cell_GTACAACGATAC_reads.fastq.gz
cell_CAGGATGCGCAG	example/reads_split/cell_CAGGATGCGCAG.umi.txt	example/reads_split/cell_CAGGATGCGCAG_reads.fastq.gz
cell_CAAAAACGTTGA	example/reads_split/cell_CAAAAACGTTGA.umi.txt	example/reads_split/cell_CAAAAACGTTGA_reads.fastq.gz
cell_GTGTGGGTCTCT	example/reads_split/cell_GTGTGGGTCTCT.umi.txt	example/reads_split/cell_GTGTGGGTCTCT_reads.fastq.gz
cell_ATTTAGGTGGCC	example/reads_split/cell_ATTTAGGTGGCC.umi.txt	example/reads_split/cell_ATTTAGGTGGCC_reads.fastq.gz
cell_CTGTGCCGACGT	example/reads_split/cell_CTGTGCCGACGT.umi.txt	example/reads_split/cell_CTGTGCCGACGT_reads.fastq.gz
cell_TCTTATCCACAG	example/reads_split/cell_TCTTATCCACAG.umi.txt	example/reads_split/cell_TCTTATCCACAG_reads.fastq.gz
cell_AGTACCCCGTAG	example/reads_split/cell_AGTACCCCGTAG.umi.txt	example/reads_split/cell_AGTACCCCGTAG_reads.fastq.gz
cell_TATCAGTGGAGA	example/reads_split/cell_TATCAGTGGAGA.umi.txt	example/reads_split/cell_TATCAGTGGAGA_reads.fastq.gz
cell_GCCTCATGTGAA	example/reads_split/cell_GCCTCATGTGAA.umi.txt	example/reads_split/cell_GCCTCATGTGAA_reads.fastq.gz
cell_GCGGGGAGTGAG	example/reads_split/cell_GCGGGGAGTGAG.umi.txt	example/reads_split/cell_GCGGGGAGTGAG_reads.fastq.gz
cell_TCCGAAATCACA	example/reads_split/cell_TCCGAAATCACA.umi.txt	example/reads_split/cell_TCCGAAATCACA_reads.fastq.gz
cell_TAAAGCTGTCTC	example/reads_split/cell_TAAAGCTGTCTC.umi.txt	example/reads_split/cell_TAAAGCTGTCTC_reads.fastq.gz
cell_CCTGTGCTGCGG	example/reads_split/cell_CCTGTGCTGCGG.umi.txt	example/reads_split/cell_CCTGTGCTGCGG_reads.fastq.gz
cell_ATCGTGGAAGTC	example/reads_split/cell_ATCGTGGAAGTC.umi.txt	example/reads_split/cell_ATCGTGGAAGTC_reads.fastq.gz
cell_AATAAAACCGCA	example/reads_split/cell_AATAAAACCGCA.umi.txt	example/reads_split/cell_AATAAAACCGCA_reads.fastq.gz
cell_ACGATGTGATGG	example/reads_split/cell_ACGATGTGATGG.umi.txt	example/reads_split/cell_ACGATGTGATGG_reads.fastq.gz
cell_ATCCTCGGGCAG	example/reads_split/cell_ATCCTCGGGCAG.umi.txt	example/reads_split/cell_ATCCTCGGGCAG_reads.fastq.gz
cell_AGTACCTGTCTC	example/reads_split/cell_AGTACCTGTCTC.umi.txt	example/reads_split/cell_AGTACCTGTCTC_reads.fastq.gz
cell_GTTCGGCGATCT	example/reads_split/cell_GTTCGGCGATCT.umi.txt	example/reads_split/cell_GTTCGGCGATCT_reads.fastq.gz
cell_CCACCGGGCCCG	example/reads_split/cell_CCACCGGGCCCG.umi.txt	example/reads_split/cell_CCACCGGGCCCG_reads.fastq.gz
cell_AGGTTCCGAAGG	example/reads_split/cell_AGGTTCCGAAGG.umi.txt	example/reads_split/cell_AGGTTCCGAAGG_reads.fastq.gz
cell_TAATATGGCGTG	example/reads_split/cell_TAATATGGCGTG.umi.txt	example/reads_split/cell_TAATATGGCGTG_reads.fastq.gz
cell_ATATACAACCCT	example/reads_split/cell_ATATACAACCCT.umi.txt	example/reads_split/cell_ATATACAACCCT_reads.fastq.gz
cell_AAATCGTACAGA	example/reads_split/cell_AAATCGTACAGA.umi.txt	example/reads_split/cell_AAATCGTACAGA_reads.fastq.gz
cell_TTTTGTATCACG	example/reads_split/cell_TTTTGTATCACG.umi.txt	example/reads_split/cell_TTTTGTATCACG_reads.fastq.gz
cell_GTAGATTGCCAC	example/reads_split/cell_GTAGATTGCCAC.umi.txt	example/reads_split/cell_GTAGATTGCCAC_reads.fastq.gz
cell_TGCGTAATGCCG	example/reads_split/cell_TGCGTAATGCCG.umi.txt	example/reads_split/cell_TGCGTAATGCCG_reads.fastq.gz
cell_GAGAGGTGGTTC	example/reads_split/cell_GAGAGGTGGTTC.umi.txt	example/reads_split/cell_GAGAGGTGGTTC_reads.fastq.gz
cell_TCTACCATAGTA	example/reads_split/cell_TCTACCATAGTA.umi.txt	example/reads_split/cell_TCTACCATAGTA_reads.fastq.gz
cell_ATTAAAATTAGT	example/reads_split/cell_ATTAAAATTAGT.umi.txt	example/reads_split/cell_ATTAAAATTAGT_reads.fastq.gz
cell_ATTTTCGAAGGC	example/reads_split/cell_ATTTTCGAAGGC.umi.txt	example/reads_split/cell_ATTTTCGAAGGC_reads.fastq.gz
cell_AAACCTCTGCTG	example/reads_split/cell_AAACCTCTGCTG.umi.txt	example/reads_split/cell_AAACCTCTGCTG_reads.fastq.gz
cell_TGAAAGTACTAT	example/reads_split/cell_TGAAAGTACTAT.umi.txt	example/reads_split/cell_TGAAAGTACTAT_reads.fastq.gz
cell_GTTATATTAGGC	example/reads_split/cell_GTTATATTAGGC.umi.txt	example/reads_split/cell_GTTATATTAGGC_reads.fastq.gz
cell_CAGAGTTATAGG	example/reads_split/cell_CAGAGTTATAGG.umi.txt	example/reads_split/cell_CAGAGTTATAGG_reads.fastq.gz
cell_GGTGGTCTTTTG	example/reads_split/cell_GGTGGTCTTTTG.umi.txt	example/reads_split/cell_GGTGGTCTTTTG_reads.fastq.gz
cell_GATAGGGAGGTG	example/reads_split/cell_GATAGGGAGGTG.umi.txt	example/reads_split/cell_GATAGGGAGGTG_reads.fastq.gz
cell_GAACAGACATCA	example/reads_split/cell_GAACAGACATCA.umi.txt	example/reads_split/cell_GAACAGACATCA_reads.fastq.gz
cell_CCGAATGGTCAC	example/reads_split/cell_CCGAATGGTCAC.umi.txt	example/reads_split/cell_CCGAATGGTCAC_reads.fastq.gz
cell_TCTCAACTCCGT	example/reads_split/cell_TCTCAACTCCGT.umi.txt	example/reads_split/cell_TCTCAACTCCGT_reads.fastq.gz
cell_TAACGTACAGGA	example/reads_split/cell_TAACGTACAGGA.umi.txt	example/reads_split/cell_TAACGTACAGGA_reads.fastq.gz
cell_ATACAACTCTCC	example/reads_split/cell_ATACAACTCTCC.umi.txt	example/reads_split/cell_ATACAACTCTCC_reads.fastq.gz
cell_GCAGATCGTAGG	example/reads_split/cell_GCAGATCGTAGG.umi.txt	example/reads_split/cell_GCAGATCGTAGG_reads.fastq.gz
cell_CGCAAGGATTTG	example/reads_split/cell_CGCAAGGATTTG.umi.txt	example/reads_split/cell_CGCAAGGATTTG_reads.fastq.gz
cell_AGTTATAGAGGC	example/reads_split/cell_AGTTATAGAGGC.umi.txt	example/reads_split/cell_AGTTATAGAGGC_reads.fastq.gz
cell_CCGCGTAGAGGA	example/reads_split/cell_CCGCGTAGAGGA.umi.txt	example/reads_split/cell_CCGCGTAGAGGA_reads.fastq.gz
cell_AGCCCTCCCCAG	example/reads_split/cell_AGCCCTCCCCAG.umi.txt	example/reads_split/cell_AGCCCTCCCCAG_reads.fastq.gz
cell_CATATACTCTTA	example/reads_split/cell_CATATACTCTTA.umi.txt	example/reads_split/cell_CATATACTCTTA_reads.fastq.gz
cell_CGGCTCGGGTAG	example/reads_split/cell_CGGCTCGGGTAG.umi.txt	example/reads_split/cell_CGGCTCGGGTAG_reads.fastq.gz
cell_TGCCCCGTTAGC	example/reads_split/cell_TGCCCCGTTAGC.umi.txt	example/reads_split/cell_TGCCCCGTTAGC_reads.fastq.gz
cell_TCGCATTCACTT	example/reads_split/cell_TCGCATTCACTT.umi.txt	example/reads_split/cell_TCGCATTCACTT_reads.fastq.gz
cell_ATATACCTGTCT	example/reads_split/cell_ATATACCTGTCT.umi.txt	example/reads_split/cell_ATATACCTGTCT_reads.fastq.gz
cell_GCGTGGCAGTTG	example/reads_split/cell_GCGTGGCAGTTG.umi.txt	example/reads_split/cell_GCGTGGCAGTTG_reads.fastq.gz
cell_TGAAGAGGTATT	example/reads_split/cell_TGAAGAGGTATT.umi.txt	example/reads_split/cell_TGAAGAGGTATT_reads.fastq.gz
cell_ACCTTGCCCTGC	example/reads_split/cell_ACCTTGCCCTGC.umi.txt	example/reads_split/cell_ACCTTGCCCTGC_reads.fastq.gz
cell_GTTTCACCGGTC	example/reads_split/cell_GTTTCACCGGTC.umi.txt	example/reads_split/cell_GTTTCACCGGTC_reads.fastq.gz
cell_TGATGCTGGGCC	example/reads_split/cell_TGATGCTGGGCC.umi.txt	example/reads_split/cell_TGATGCTGGGCC_reads.fastq.gz
cell_CCCGATTTCCCT	example/reads_split/cell_CCCGATTTCCCT.umi.txt	example/reads_split/cell_CCCGATTTCCCT_reads.fastq.gz
cell_CTTTCCCTGAGA	example/reads_split/cell_CTTTCCCTGAGA.umi.txt	example/reads_split/cell_CTTTCCCTGAGA_reads.fastq.gz
cell_TTGGCCAATAGT	example/reads_split/cell_TTGGCCAATAGT.umi.txt	example/reads_split/cell_TTGGCCAATAGT_reads.fastq.gz
cell_CTTCCGCGAACG	example/reads_split/cell_CTTCCGCGAACG.umi.txt	example/reads_split/cell_CTTCCGCGAACG_reads.fastq.gz
cell_AGTTGGTTCCAA	example/reads_split/cell_AGTTGGTTCCAA.umi.txt	example/reads_split/cell_AGTTGGTTCCAA_reads.fastq.gz
cell_AACCGGGCGCAA	example/reads_split/cell_AACCGGGCGCAA.umi.txt	example/reads_split/cell_AACCGGGCGCAA_reads.fastq.gz
cell_CCAGATTAATCT	example/reads_split/cell_CCAGATTAATCT.umi.txt	example/reads_split/cell_CCAGATTAATCT_reads.fastq.gz
cell_CTAGTTGAACAC	example/reads_split/cell_CTAGTTGAACAC.umi.txt	example/reads_split/cell_CTAGTTGAACAC_reads.fastq.gz
cell_CTGCGCGGCGGC	example/reads_split/cell_CTGCGCGGCGGC.umi.txt	example/reads_split/cell_CTGCGCGGCGGC_reads.fastq.gz
cell_GGCATGATACTA	example/reads_split/cell_GGCATGATACTA.umi.txt	example/reads_split/cell_GGCATGATACTA_reads.fastq.gz
cell_GACGACCATAAT	example/reads_split/cell_GACGACCATAAT.umi.txt	example/reads_split/cell_GACGACCATAAT_reads.fastq.gz
cell_CCCTGTCTCTTA	example/reads_split/cell_CCCTGTCTCTTA.umi.txt	example/reads_split/cell_CCCTGTCTCTTA_reads.fastq.gz
cell_GCTTAGAGCTGT	example/reads_split/cell_GCTTAGAGCTGT.umi.txt	example/reads_split/cell_GCTTAGAGCTGT_reads.fastq.gz
cell_GTGGATCGAAGA	example/reads_split/cell_GTGGATCGAAGA.umi.txt	example/reads_split/cell_GTGGATCGAAGA_reads.fastq.gz
cell_TGAGTGAGGCAG	example/reads_split/cell_TGAGTGAGGCAG.umi.txt	example/reads_split/cell_TGAGTGAGGCAG_reads.fastq.gz
cell_ATCTATCATATT	example/reads_split/cell_ATCTATCATATT.umi.txt	example/reads_split/cell_ATCTATCATATT_reads.fastq.gz
cell_TGAGCCAGGGTA	example/reads_split/cell_TGAGCCAGGGTA.umi.txt	example/reads_split/cell_TGAGCCAGGGTA_reads.fastq.gz
cell_ATAGTTTTTTAA	example/reads_split/cell_ATAGTTTTTTAA.umi.txt	example/reads_split/cell_ATAGTTTTTTAA_reads.fastq.gz
cell_CTGCTCTTTGCA	example/reads_split/cell_CTGCTCTTTGCA.umi.txt	example/reads_split/cell_CTGCTCTTTGCA_reads.fastq.gz
cell_CGACAGTTGGCT	example/reads_split/cell_CGACAGTTGGCT.umi.txt	example/reads_split/cell_CGACAGTTGGCT_reads.fastq.gz
cell_AATATTTTGAAA	example/reads_split/cell_AATATTTTGAAA.umi.txt	example/reads_split/cell_AATATTTTGAAA_reads.fastq.gz
cell_GAATATATCCTC	example/reads_split/cell_GAATATATCCTC.umi.txt	example/reads_split/cell_GAATATATCCTC_reads.fastq.gz
cell_TGTTTTTAATAC	example/reads_split/cell_TGTTTTTAATAC.umi.txt	example/reads_split/cell_TGTTTTTAATAC_reads.fastq.gz
cell_CACTAATAATGG	example/reads_split/cell_CACTAATAATGG.umi.txt	example/reads_split/cell_CACTAATAATGG_reads.fastq.gz
cell_CGACACGGCTAA	example/reads_split/cell_CGACACGGCTAA.umi.txt	example/reads_split/cell_CGACACGGCTAA_reads.fastq.gz
cell_GATGCGACGGTC	example/reads_split/cell_GATGCGACGGTC.umi.txt	example/reads_split/cell_GATGCGACGGTC_reads.fastq.gz
cell_ATGTGGGACGTC	example/reads_split/cell_ATGTGGGACGTC.umi.txt	example/reads_split/cell_ATGTGGGACGTC_reads.fastq.gz
cell_TCGTGTGCTTGC	example/reads_split/cell_TCGTGTGCTTGC.umi.txt	example/reads_split/cell_TCGTGTGCTTGC_reads.fastq.gz
cell_ATGAGGCACAGA	example/reads_split/cell_ATGAGGCACAGA.umi.txt	example/reads_split/cell_ATGAGGCACAGA_reads.fastq.gz
cell_TAAGGTCGCCCA	example/reads_split/cell_TAAGGTCGCCCA.umi.txt	example/reads_split/cell_TAAGGTCGCCCA_reads.fastq.gz
cell_TACTCCACAGAA	example/reads_split/cell_TACTCCACAGAA.umi.txt	example/reads_split/cell_TACTCCACAGAA_reads.fastq.gz
cell_TTGCTACTGACG	example/reads_split/cell_TTGCTACTGACG.umi.txt	example/reads_split/cell_TTGCTACTGACG_reads.fastq.gz
cell_TCCTAGTGTGAT	example/reads_split/cell_TCCTAGTGTGAT.umi.txt	example/reads_split/cell_TCCTAGTGTGAT_reads.fastq.gz
cell_AGGTGCAGCGTT	example/reads_split/cell_AGGTGCAGCGTT.umi.txt	example/reads_split/cell_AGGTGCAGCGTT_reads.fastq.gz
cell_GGATGAGAGGTA	example/reads_split/cell_GGATGAGAGGTA.umi.txt	example/reads_split/cell_GGATGAGAGGTA_reads.fastq.gz
cell_ATGGGTCATCGC	example/reads_split/cell_ATGGGTCATCGC.umi.txt	example/reads_split/cell_ATGGGTCATCGC_reads.fastq.gz
cell_GTTAACGCAACG	example/reads_split/cell_GTTAACGCAACG.umi.txt	example/reads_split/cell_GTTAACGCAACG_reads.fastq.gz
cell_AAGCGATCGATA	example/reads_split/cell_AAGCGATCGATA.umi.txt	example/reads_split/cell_AAGCGATCGATA_reads.fastq.gz
cell_GTGTGACGTATT	example/reads_split/cell_GTGTGACGTATT.umi.txt	example/reads_split/cell_GTGTGACGTATT_reads.fastq.gz
cell_ACGACAGTATTC	example/reads_split/cell_ACGACAGTATTC.umi.txt	example/reads_split/cell_ACGACAGTATTC_reads.fastq.gz
cell_AGTCCGAGAGTG	example/reads_split/cell_AGTCCGAGAGTG.umi.txt	example/reads_split/cell_AGTCCGAGAGTG_reads.fastq.gz
cell_GTTTGTGCAAAC	example/reads_split/cell_GTTTGTGCAAAC.umi.txt	example/reads_split/cell_GTTTGTGCAAAC_reads.fastq.gz
cell_GATCACTATTTT	example/reads_split/cell_GATCACTATTTT.umi.txt	example/reads_split/cell_GATCACTATTTT_reads.fastq.gz
cell_ATAAGGCATTAC	example/reads_split/cell_ATAAGGCATTAC.umi.txt	example/reads_split/cell_ATAAGGCATTAC_reads.fastq.gz
cell_CGTCTATGTTTG	example/reads_split/cell_CGTCTATGTTTG.umi.txt	example/reads_split/cell_CGTCTATGTTTG_reads.fastq.gz
cell_CCGACGCGGCTA	example/reads_split/cell_CCGACGCGGCTA.umi.txt	example/reads_split/cell_CCGACGCGGCTA_reads.fastq.gz
cell_GCCACAAGTAGG	example/reads_split/cell_GCCACAAGTAGG.umi.txt	example/reads_split/cell_GCCACAAGTAGG_reads.fastq.gz
cell_GTACAGGATTAG	example/reads_split/cell_GTACAGGATTAG.umi.txt	example/reads_split/cell_GTACAGGATTAG_reads.fastq.gz
cell_CACCAATGAGAC	example/reads_split/cell_CACCAATGAGAC.umi.txt	example/reads_split/cell_CACCAATGAGAC_reads.fastq.gz
cell_GTGACATTGTTC	example/reads_split/cell_GTGACATTGTTC.umi.txt	example/reads_split/cell_GTGACATTGTTC_reads.fastq.gz
cell_TCTCGCTGATCC	example/reads_split/cell_TCTCGCTGATCC.umi.txt	example/reads_split/cell_TCTCGCTGATCC_reads.fastq.gz
cell_GATCACATGGGT	example/reads_split/cell_GATCACATGGGT.umi.txt	example/reads_split/cell_GATCACATGGGT_reads.fastq.gz
cell_TTAGGTAACGTG	example/reads_split/cell_TTAGGTAACGTG.umi.txt	example/reads_split/cell_TTAGGTAACGTG_reads.fastq.gz
cell_TTCCCCCCTAGG	example/reads_split/cell_TTCCCCCCTAGG.umi.txt	example/reads_split/cell_TTCCCCCCTAGG_reads.fastq.gz
cell_CAACGCTGTCGG	example/reads_split/cell_CAACGCTGTCGG.umi.txt	example/reads_split/cell_CAACGCTGTCGG_reads.fastq.gz
cell_GGCTCGATGCAT	example/reads_split/cell_GGCTCGATGCAT.umi.txt	example/reads_split/cell_GGCTCGATGCAT_reads.fastq.gz
cell_TGGGCCATACAG	example/reads_split/cell_TGGGCCATACAG.umi.txt	example/reads_split/cell_TGGGCCATACAG_reads.fastq.gz
cell_CAACGCACTAGA	example/reads_split/cell_CAACGCACTAGA.umi.txt	example/reads_split/cell_CAACGCACTAGA_reads.fastq.gz
cell_ATTAATGAGAAT	example/reads_split/cell_ATTAATGAGAAT.umi.txt	example/reads_split/cell_ATTAATGAGAAT_reads.fastq.gz
cell_AAGGTTTCGGAA	example/reads_split/cell_AAGGTTTCGGAA.umi.txt	example/reads_split/cell_AAGGTTTCGGAA_reads.fastq.gz
cell_GATTCTTCGAAG	example/reads_split/cell_GATTCTTCGAAG.umi.txt	example/reads_split/cell_GATTCTTCGAAG_reads.fastq.gz
cell_GTGCTTCGCCAA	example/reads_split/cell_GTGCTTCGCCAA.umi.txt	example/reads_split/cell_GTGCTTCGCCAA_reads.fastq.gz
cell_GCATTCACTTAG	example/reads_split/cell_GCATTCACTTAG.umi.txt	example/reads_split/cell_GCATTCACTTAG_reads.fastq.gz
cell_GCCCATCCACGG	example/reads_split/cell_GCCCATCCACGG.umi.txt	example/reads_split/cell_GCCCATCCACGG_reads.fastq.gz
cell_GAAAGTATGCTT	example/reads_split/cell_GAAAGTATGCTT.umi.txt	example/reads_split/cell_GAAAGTATGCTT_reads.fastq.gz
cell_ACTTCATGACCC	example/reads_split/cell_ACTTCATGACCC.umi.txt	example/reads_split/cell_ACTTCATGACCC_reads.fastq.gz
cell_GTAGAGTCCATT	example/reads_split/cell_GTAGAGTCCATT.umi.txt	example/reads_split/cell_GTAGAGTCCATT_reads.fastq.gz
cell_CGAGTGTACCCA	example/reads_split/cell_CGAGTGTACCCA.umi.txt	example/reads_split/cell_CGAGTGTACCCA_reads.fastq.gz
cell_CAAAGTTCATCG	example/reads_split/cell_CAAAGTTCATCG.umi.txt	example/reads_split/cell_CAAAGTTCATCG_reads.fastq.gz
cell_TCTTCTAGTCGG	example/reads_split/cell_TCTTCTAGTCGG.umi.txt	example/reads_split/cell_TCTTCTAGTCGG_reads.fastq.gz
cell_CCACTCCCCCCT	example/reads_split/cell_CCACTCCCCCCT.umi.txt	example/reads_split/cell_CCACTCCCCCCT_reads.fastq.gz
cell_ACAAGATCTCGC	example/reads_split/cell_ACAAGATCTCGC.umi.txt	example/reads_split/cell_ACAAGATCTCGC_reads.fastq.gz
cell_GTTCAACCCCGG	example/reads_split/cell_GTTCAACCCCGG.umi.txt	example/reads_split/cell_GTTCAACCCCGG_reads.fastq.gz
cell_AACTCCCTCTGT	example/reads_split/cell_AACTCCCTCTGT.umi.txt	example/reads_split/cell_AACTCCCTCTGT_reads.fastq.gz
cell_CTTGCCTGAATA	example/reads_split/cell_CTTGCCTGAATA.umi.txt	example/reads_split/cell_CTTGCCTGAATA_reads.fastq.gz
cell_CTTAAACACCAG	example/reads_split/cell_CTTAAACACCAG.umi.txt	example/reads_split/cell_CTTAAACACCAG_reads.fastq.gz
cell_TACAAGCTAGGT	example/reads_split/cell_TACAAGCTAGGT.umi.txt	example/reads_split/cell_TACAAGCTAGGT_reads.fastq.gz
cell_GATCGCTCACTT	example/reads_split/cell_GATCGCTCACTT.umi.txt	example/reads_split/cell_GATCGCTCACTT_reads.fastq.gz
cell_GAATATAAGATA	example/reads_split/cell_GAATATAAGATA.umi.txt	example/reads_split/cell_GAATATAAGATA_reads.fastq.gz
cell_TGGATGAAGCCT	example/reads_split/cell_TGGATGAAGCCT.umi.txt	example/reads_split/cell_TGGATGAAGCCT_reads.fastq.gz
cell_TATAAAACTGTG	example/reads_split/cell_TATAAAACTGTG.umi.txt	example/reads_split/cell_TATAAAACTGTG_reads.fastq.gz
cell_CGCGATACCACA	example/reads_split/cell_CGCGATACCACA.umi.txt	example/reads_split/cell_CGCGATACCACA_reads.fastq.gz
cell_unassigned	example/reads_split/cell_unassigned.umi.txt	example/reads_split/cell_unassigned_reads.fastq.gz
cell_AACTAGTCGCAG	example/reads_split/cell_AACTAGTCGCAG.umi.txt	example/reads_split/cell_AACTAGTCGCAG_reads.fastq.gz
cell_ACTAAGGACCGC	example/reads_split/cell_ACTAAGGACCGC.umi.txt	example/reads_split/cell_ACTAAGGACCGC_reads.fastq.gz
cell_ACGGCCTCTATG	example/reads_split/cell_ACGGCCTCTATG.umi.txt	example/reads_split/cell_ACGGCCTCTATG_reads.fastq.gz
cell_ACAACAGCCCCT	example/reads_split/cell_ACAACAGCCCCT.umi.txt	example/reads_split/cell_ACAACAGCCCCT_reads.fastq.gz
cell_AGCACATCACTT	example/reads_split/cell_AGCACATCACTT.umi.txt	example/reads_split/cell_AGCACATCACTT_reads.fastq.gz
cell_GGAGCCTAGGCG	example/reads_split/cell_GGAGCCTAGGCG.umi.txt	example/reads_split/cell_GGAGCCTAGGCG_reads.fastq.gz
cell_AAGATCGTACGT	example/reads_split/cell_AAGATCGTACGT.umi.txt	example/reads_split/cell_AAGATCGTACGT_reads.fastq.gz
cell_TCAATTGGCTTC	example/reads_split/cell_TCAATTGGCTTC.umi.txt	example/reads_split/cell_TCAATTGGCTTC_reads.fastq.gz
cell_AATCACGATCAA	example/reads_split/cell_AATCACGATCAA.umi.txt	example/reads_split/cell_AATCACGATCAA_reads.fastq.gz
cell_CCTGACGAGCAG	example/reads_split/cell_CCTGACGAGCAG.umi.txt	example/reads_split/cell_CCTGACGAGCAG_reads.fastq.gz
cell_GCTGTCCTGGGT	example/reads_split/cell_GCTGTCCTGGGT.umi.txt	example/reads_split/cell_GCTGTCCTGGGT_reads.fastq.gz
cell_ACTGAAGCTAAT	example/reads_split/cell_ACTGAAGCTAAT.umi.txt	example/reads_split/cell_ACTGAAGCTAAT_reads.fastq.gz
cell_TTAGATTTTAGC	example/reads_split/cell_TTAGATTTTAGC.umi.txt	example/reads_split/cell_TTAGATTTTAGC_reads.fastq.gz
cell_GTACTTGTACCC	example/reads_split/cell_GTACTTGTACCC.umi.txt	example/reads_split/cell_GTACTTGTACCC_reads.fastq.gz
cell_CGGTAACTAAGC	example/reads_split/cell_CGGTAACTAAGC.umi.txt	example/reads_split/cell_CGGTAACTAAGC_reads.fastq.gz
cell_GGGCAATCCGCT	example/reads_split/cell_GGGCAATCCGCT.umi.txt	example/reads_split/cell_GGGCAATCCGCT_reads.fastq.gz
cell_CCCGCCTTGACC	example/reads_split/cell_CCCGCCTTGACC.umi.txt	example/reads_split/cell_CCCGCCTTGACC_reads.fastq.gz
cell_GGGAATAACGGC	example/reads_split/cell_GGGAATAACGGC.umi.txt	example/reads_split/cell_GGGAATAACGGC_reads.fastq.gz
cell_CCGGATACATAT	example/reads_split/cell_CCGGATACATAT.umi.txt	example/reads_split/cell_CCGGATACATAT_reads.fastq.gz
cell_GAGTACACGCCG	example/reads_split/cell_GAGTACACGCCG.umi.txt	example/reads_split/cell_GAGTACACGCCG_reads.fastq.gz
cell_CTGTCTCTTATA	example/reads_split/cell_CTGTCTCTTATA.umi.txt	example/reads_split/cell_CTGTCTCTTATA_reads.fastq.gz
cell_TGCTGTCCAGTC	example/reads_split/cell_TGCTGTCCAGTC.umi.txt	example/reads_split/cell_TGCTGTCCAGTC_reads.fastq.gz
cell_GATGCTAGGAGA	example/reads_split/cell_GATGCTAGGAGA.umi.txt	example/reads_split/cell_GATGCTAGGAGA_reads.fastq.gz
cell_GATATTTTTCGA	example/reads_split/cell_GATATTTTTCGA.umi.txt	example/reads_split/cell_GATATTTTTCGA_reads.fastq.gz
cell_TATCAGGCGGTC	example/reads_split/cell_TATCAGGCGGTC.umi.txt	example/reads_split/cell_TATCAGGCGGTC_reads.fastq.gz
cell_GTGTACTCGGGA	example/reads_split/cell_GTGTACTCGGGA.umi.txt	example/reads_split/cell_GTGTACTCGGGA_reads.fastq.gz
cell_CGACAAATTGTT	example/reads_split/cell_CGACAAATTGTT.umi.txt	example/reads_split/cell_CGACAAATTGTT_reads.fastq.gz
cell_TGACTCATGATC	example/reads_split/cell_TGACTCATGATC.umi.txt	example/reads_split/cell_TGACTCATGATC_reads.fastq.gz
cell_TTCTACTATCTC	example/reads_split/cell_TTCTACTATCTC.umi.txt	example/reads_split/cell_TTCTACTATCTC_reads.fastq.gz
cell_TGTAACGCACGA	example/reads_split/cell_TGTAACGCACGA.umi.txt	example/reads_split/cell_TGTAACGCACGA_reads.fastq.gz
cell_GGTCGCTGTGTG	example/reads_split/cell_GGTCGCTGTGTG.umi.txt	example/reads_split/cell_GGTCGCTGTGTG_reads.fastq.gz
cell_CATAACCTAGTC	example/reads_split/cell_CATAACCTAGTC.umi.txt	example/reads_split/cell_CATAACCTAGTC_reads.fastq.gz
cell_TGCGTTCCACAT	example/reads_split/cell_TGCGTTCCACAT.umi.txt	example/reads_split/cell_TGCGTTCCACAT_reads.fastq.gz
cell_GGTTTCATATTT	example/reads_split/cell_GGTTTCATATTT.umi.txt	example/reads_split/cell_GGTTTCATATTT_reads.fastq.gz
cell_CCTTTAAATGCG	example/reads_split/cell_CCTTTAAATGCG.umi.txt	example/reads_split/cell_CCTTTAAATGCG_reads.fastq.gz
cell_GGATGCGTTCCC	example/reads_split/cell_GGATGCGTTCCC.umi.txt	example/reads_split/cell_GGATGCGTTCCC_reads.fastq.gz
cell_TGTGTGGGTTCC	example/reads_split/cell_TGTGTGGGTTCC.umi.txt	example/reads_split/cell_TGTGTGGGTTCC_reads.fastq.gz
cell_CCTATCAAGTAC	example/reads_split/cell_CCTATCAAGTAC.umi.txt	example/reads_split/cell_CCTATCAAGTAC_reads.fastq.gz
cell_GAGTAGAGGTGC	example/reads_split/cell_GAGTAGAGGTGC.umi.txt	example/reads_split/cell_GAGTAGAGGTGC_reads.fastq.gz
cell_GATCGTGTCTCC	example/reads_split/cell_GATCGTGTCTCC.umi.txt	example/reads_split/cell_GATCGTGTCTCC_reads.fastq.gz
cell_CGCTAGTCTCTC	example/reads_split/cell_CGCTAGTCTCTC.umi.txt	example/reads_split/cell_CGCTAGTCTCTC_reads.fastq.gz
cell_CAACACTGGCTC	example/reads_split/cell_CAACACTGGCTC.umi.txt	example/reads_split/cell_CAACACTGGCTC_reads.fastq.gz
cell_TACTGTGTGCAC	example/reads_split/cell_TACTGTGTGCAC.umi.txt	example/reads_split/cell_TACTGTGTGCAC_reads.fastq.gz
cell_ACCGTTTAAAAA	example/reads_split/cell_ACCGTTTAAAAA.umi.txt	example/reads_split/cell_ACCGTTTAAAAA_reads.fastq.gz
cell_ATGAAGACCATT	example/reads_split/cell_ATGAAGACCATT.umi.txt	example/reads_split/cell_ATGAAGACCATT_reads.fastq.gz
cell_TGTTATACCTGT	example/reads_split/cell_TGTTATACCTGT.umi.txt	example/reads_split/cell_TGTTATACCTGT_reads.fastq.gz
cell_ACCAGCTCGCAA	example/reads_split/cell_ACCAGCTCGCAA.umi.txt	example/reads_split/cell_ACCAGCTCGCAA_reads.fastq.gz
cell_AACCAAGGCCAT	example/reads_split/cell_AACCAAGGCCAT.umi.txt	example/reads_split/cell_AACCAAGGCCAT_reads.fastq.gz
cell_GCTGATTTCAAG	example/reads_split/cell_GCTGATTTCAAG.umi.txt	example/reads_split/cell_GCTGATTTCAAG_reads.fastq.gz
cell_CCCTTCGTCTGC	example/reads_split/cell_CCCTTCGTCTGC.umi.txt	example/reads_split/cell_CCCTTCGTCTGC_reads.fastq.gz
cell_ACGAGCGCTTAA	example/reads_split/cell_ACGAGCGCTTAA.umi.txt	example/reads_split/cell_ACGAGCGCTTAA_reads.fastq.gz
cell_GCATGAAACTTC	example/reads_split/cell_GCATGAAACTTC.umi.txt	example/reads_split/cell_GCATGAAACTTC_reads.fastq.gz
cell_TTGGAGACGGTA	example/reads_split/cell_TTGGAGACGGTA.umi.txt	example/reads_split/cell_TTGGAGACGGTA_reads.fastq.gz
cell_TGAGAAAGTCTT	example/reads_split/cell_TGAGAAAGTCTT.umi.txt	example/reads_split/cell_TGAGAAAGTCTT_reads.fastq.gz
cell_ATATGACAGCAT	example/reads_split/cell_ATATGACAGCAT.umi.txt	example/reads_split/cell_ATATGACAGCAT_reads.fastq.gz
cell_TTTTACGGTATT	example/reads_split/cell_TTTTACGGTATT.umi.txt	example/reads_split/cell_TTTTACGGTATT_reads.fastq.gz
cell_AGGGAAGGGACC	example/reads_split/cell_AGGGAAGGGACC.umi.txt	example/reads_split/cell_AGGGAAGGGACC_reads.fastq.gz
cell_GGACAGGACGTA	example/reads_split/cell_GGACAGGACGTA.umi.txt	example/reads_split/cell_GGACAGGACGTA_reads.fastq.gz
cell_AGATTCTAAGCT	example/reads_split/cell_AGATTCTAAGCT.umi.txt	example/reads_split/cell_AGATTCTAAGCT_reads.fastq.gz
cell_CCCACGCGGAAG	example/reads_split/cell_CCCACGCGGAAG.umi.txt	example/reads_split/cell_CCCACGCGGAAG_reads.fastq.gz
cell_GCGATGTCGACG	example/reads_split/cell_GCGATGTCGACG.umi.txt	example/reads_split/cell_GCGATGTCGACG_reads.fastq.gz
cell_ATTCGTGTTATC	example/reads_split/cell_ATTCGTGTTATC.umi.txt	example/reads_split/cell_ATTCGTGTTATC_reads.fastq.gz
cell_TTCCAAGGGACA	example/reads_split/cell_TTCCAAGGGACA.umi.txt	example/reads_split/cell_TTCCAAGGGACA_reads.fastq.gz
cell_GACAACTCATTA	example/reads_split/cell_GACAACTCATTA.umi.txt	example/reads_split/cell_GACAACTCATTA_reads.fastq.gz
cell_TGGCGCCGTATA	example/reads_split/cell_TGGCGCCGTATA.umi.txt	example/reads_split/cell_TGGCGCCGTATA_reads.fastq.gz
cell_GCTGCCTACGCT	example/reads_split/cell_GCTGCCTACGCT.umi.txt	example/reads_split/cell_GCTGCCTACGCT_reads.fastq.gz
cell_ATTTAGCAGACG	example/reads_split/cell_ATTTAGCAGACG.umi.txt	example/reads_split/cell_ATTTAGCAGACG_reads.fastq.gz
cell_TTGAAGAGGAGC	example/reads_split/cell_TTGAAGAGGAGC.umi.txt	example/reads_split/cell_TTGAAGAGGAGC_reads.fastq.gz
cell_TGTAAGTTATCT	example/reads_split/cell_TGTAAGTTATCT.umi.txt	example/reads_split/cell_TGTAAGTTATCT_reads.fastq.gz
cell_CCAACTTCAGAG	example/reads_split/cell_CCAACTTCAGAG.umi.txt	example/reads_split/cell_CCAACTTCAGAG_reads.fastq.gz
cell_TGGCGTTGCACC	example/reads_split/cell_TGGCGTTGCACC.umi.txt	example/reads_split/cell_TGGCGTTGCACC_reads.fastq.gz
cell_GGTCTTATGTTA	example/reads_split/cell_GGTCTTATGTTA.umi.txt	example/reads_split/cell_GGTCTTATGTTA_reads.fastq.gz
cell_GTGTGATAATCC	example/reads_split/cell_GTGTGATAATCC.umi.txt	example/reads_split/cell_GTGTGATAATCC_reads.fastq.gz
cell_TGGATGTTCAAG	example/reads_split/cell_TGGATGTTCAAG.umi.txt	example/reads_split/cell_TGGATGTTCAAG_reads.fastq.gz
cell_ACCACACGTTTT	example/reads_split/cell_ACCACACGTTTT.umi.txt	example/reads_split/cell_ACCACACGTTTT_reads.fastq.gz
cell_TAAGGTACTGAG	example/reads_split/cell_TAAGGTACTGAG.umi.txt	example/reads_split/cell_TAAGGTACTGAG_reads.fastq.gz
cell_AATTAATCGTCT	example/reads_split/cell_AATTAATCGTCT.umi.txt	example/reads_split/cell_AATTAATCGTCT_reads.fastq.gz
cell_CGCATGCGCCAA	example/reads_split/cell_CGCATGCGCCAA.umi.txt	example/reads_split/cell_CGCATGCGCCAA_reads.fastq.gz
cell_GATACAACGCCA	example/reads_split/cell_GATACAACGCCA.umi.txt	example/reads_split/cell_GATACAACGCCA_reads.fastq.gz
cell_CTGAGGCGGCCG	example/reads_split/cell_CTGAGGCGGCCG.umi.txt	example/reads_split/cell_CTGAGGCGGCCG_reads.fastq.gz
cell_TACCAACCTATG	example/reads_split/cell_TACCAACCTATG.umi.txt	example/reads_split/cell_TACCAACCTATG_reads.fastq.gz
cell_ATTAGGAAGGTA	example/reads_split/cell_ATTAGGAAGGTA.umi.txt	example/reads_split/cell_ATTAGGAAGGTA_reads.fastq.gz
cell_AAGACTGCTTCC	example/reads_split/cell_AAGACTGCTTCC.umi.txt	example/reads_split/cell_AAGACTGCTTCC_reads.fastq.gz
cell_GTCGCATTCTTT	example/reads_split/cell_GTCGCATTCTTT.umi.txt	example/reads_split/cell_GTCGCATTCTTT_reads.fastq.gz
cell_CTGTAAATACAT	example/reads_split/cell_CTGTAAATACAT.umi.txt	example/reads_split/cell_CTGTAAATACAT_reads.fastq.gz
cell_AAGTGGGCATGA	example/reads_split/cell_AAGTGGGCATGA.umi.txt	example/reads_split/cell_AAGTGGGCATGA_reads.fastq.gz
cell_AACTCCTTGGTA	example/reads_split/cell_AACTCCTTGGTA.umi.txt	example/reads_split/cell_AACTCCTTGGTA_reads.fastq.gz
cell_AGCTATGTGCAG	example/reads_split/cell_AGCTATGTGCAG.umi.txt	example/reads_split/cell_AGCTATGTGCAG_reads.fastq.gz
cell_CGGCTGGTCCGC	example/reads_split/cell_CGGCTGGTCCGC.umi.txt	example/reads_split/cell_CGGCTGGTCCGC_reads.fastq.gz
cell_GGCAATGTGCCT	example/reads_split/cell_GGCAATGTGCCT.umi.txt	example/reads_split/cell_GGCAATGTGCCT_reads.fastq.gz
cell_CAGCATAGGCTG	example/reads_split/cell_CAGCATAGGCTG.umi.txt	example/reads_split/cell_CAGCATAGGCTG_reads.fastq.gz
cell_CTCGACGACAAG	example/reads_split/cell_CTCGACGACAAG.umi.txt	example/reads_split/cell_CTCGACGACAAG_reads.fastq.gz
cell_CGTGTTAGACAC	example/reads_split/cell_CGTGTTAGACAC.umi.txt	example/reads_split/cell_CGTGTTAGACAC_reads.fastq.gz
cell_GGAGTCCCAGTA	example/reads_split/cell_GGAGTCCCAGTA.umi.txt	example/reads_split/cell_GGAGTCCCAGTA_reads.fastq.gz
cell_CCCCATTGGGGC	example/reads_split/cell_CCCCATTGGGGC.umi.txt	example/reads_split/cell_CCCCATTGGGGC_reads.fastq.gz
cell_GTTACTGTCGCT	example/reads_split/cell_GTTACTGTCGCT.umi.txt	example/reads_split/cell_GTTACTGTCGCT_reads.fastq.gz
cell_ATAGTATAGACC	example/reads_split/cell_ATAGTATAGACC.umi.txt	example/reads_split/cell_ATAGTATAGACC_reads.fastq.gz
cell_ATCTGAAGCCTT	example/reads_split/cell_ATCTGAAGCCTT.umi.txt	example/reads_split/cell_ATCTGAAGCCTT_reads.fastq.gz
cell_CGATATATGTGG	example/reads_split/cell_CGATATATGTGG.umi.txt	example/reads_split/cell_CGATATATGTGG_reads.fastq.gz
cell_GAAGGCGAAGAG	example/reads_split/cell_GAAGGCGAAGAG.umi.txt	example/reads_split/cell_GAAGGCGAAGAG_reads.fastq.gz
cell_CTGTAATTGTAC	example/reads_split/cell_CTGTAATTGTAC.umi.txt	example/reads_split/cell_CTGTAATTGTAC_reads.fastq.gz
cell_CGTTCGGAAGCG	example/reads_split/cell_CGTTCGGAAGCG.umi.txt	example/reads_split/cell_CGTTCGGAAGCG_reads.fastq.gz
cell_AATAACAGTAAG	example/reads_split/cell_AATAACAGTAAG.umi.txt	example/reads_split/cell_AATAACAGTAAG_reads.fastq.gz
cell_TGGCCAAGTCTC	example/reads_split/cell_TGGCCAAGTCTC.umi.txt	example/reads_split/cell_TGGCCAAGTCTC_reads.fastq.gz
cell_GAGTATGCGACC	example/reads_split/cell_GAGTATGCGACC.umi.txt	example/reads_split/cell_GAGTATGCGACC_reads.fastq.gz
cell_CATACTATCGCC	example/reads_split/cell_CATACTATCGCC.umi.txt	example/reads_split/cell_CATACTATCGCC_reads.fastq.gz
cell_CGGAGTCAGGGC	example/reads_split/cell_CGGAGTCAGGGC.umi.txt	example/reads_split/cell_CGGAGTCAGGGC_reads.fastq.gz
cell_ACCTTCTCGAAC	example/reads_split/cell_ACCTTCTCGAAC.umi.txt	example/reads_split/cell_ACCTTCTCGAAC_reads.fastq.gz
cell_CCGTTGCCCGTA	example/reads_split/cell_CCGTTGCCCGTA.umi.txt	example/reads_split/cell_CCGTTGCCCGTA_reads.fastq.gz
cell_CAGGCGAACAGC	example/reads_split/cell_CAGGCGAACAGC.umi.txt	example/reads_split/cell_CAGGCGAACAGC_reads.fastq.gz
cell_TCAGTTACTGGA	example/reads_split/cell_TCAGTTACTGGA.umi.txt	example/reads_split/cell_TCAGTTACTGGA_reads.fastq.gz
cell_CCTCCCCGTTGA	example/reads_split/cell_CCTCCCCGTTGA.umi.txt	example/reads_split/cell_CCTCCCCGTTGA_reads.fastq.gz
cell_ACAACCTTCATA	example/reads_split/cell_ACAACCTTCATA.umi.txt	example/reads_split/cell_ACAACCTTCATA_reads.fastq.gz
cell_AGTCTATTCTGC	example/reads_split/cell_AGTCTATTCTGC.umi.txt	example/reads_split/cell_AGTCTATTCTGC_reads.fastq.gz
cell_TAACAGCGTGTA	example/reads_split/cell_TAACAGCGTGTA.umi.txt	example/reads_split/cell_TAACAGCGTGTA_reads.fastq.gz
cell_CGACAGGCGATC	example/reads_split/cell_CGACAGGCGATC.umi.txt	example/reads_split/cell_CGACAGGCGATC_reads.fastq.gz
cell_CTGGATGTTCAA	example/reads_split/cell_CTGGATGTTCAA.umi.txt	example/reads_split/cell_CTGGATGTTCAA_reads.fastq.gz
cell_ACGCGGCAGCCG	example/reads_split/cell_ACGCGGCAGCCG.umi.txt	example/reads_split/cell_ACGCGGCAGCCG_reads.fastq.gz
cell_TTCTGTACGTCT	example/reads_split/cell_TTCTGTACGTCT.umi.txt	example/reads_split/cell_TTCTGTACGTCT_reads.fastq.gz
cell_CCCAGACACACT	example/reads_split/cell_CCCAGACACACT.umi.txt	example/reads_split/cell_CCCAGACACACT_reads.fastq.gz
cell_TTCGGGCCTGCT	example/reads_split/cell_TTCGGGCCTGCT.umi.txt	example/reads_split/cell_TTCGGGCCTGCT_reads.fastq.gz
cell_GAAAGATGTATA	example/reads_split/cell_GAAAGATGTATA.umi.txt	example/reads_split/cell_GAAAGATGTATA_reads.fastq.gz
cell_TTGTATAGCGCA	example/reads_split/cell_TTGTATAGCGCA.umi.txt	example/reads_split/cell_TTGTATAGCGCA_reads.fastq.gz
cell_TTGGAGCACCTT	example/reads_split/cell_TTGGAGCACCTT.umi.txt	example/reads_split/cell_TTGGAGCACCTT_reads.fastq.gz
cell_AGTTTATAGCAG	example/reads_split/cell_AGTTTATAGCAG.umi.txt	example/reads_split/cell_AGTTTATAGCAG_reads.fastq.gz
cell_AAGACAAAGTGT	example/reads_split/cell_AAGACAAAGTGT.umi.txt	example/reads_split/cell_AAGACAAAGTGT_reads.fastq.gz
cell_TAATCGGTGGCA	example/reads_split/cell_TAATCGGTGGCA.umi.txt	example/reads_split/cell_TAATCGGTGGCA_reads.fastq.gz
cell_GAGTCACTGCAA	example/reads_split/cell_GAGTCACTGCAA.umi.txt	example/reads_split/cell_GAGTCACTGCAA_reads.fastq.gz
cell_TGACGCTAAGGG	example/reads_split/cell_TGACGCTAAGGG.umi.txt	example/reads_split/cell_TGACGCTAAGGG_reads.fastq.gz
cell_GGTTTGAACCCA	example/reads_split/cell_GGTTTGAACCCA.umi.txt	example/reads_split/cell_GGTTTGAACCCA_reads.fastq.gz
cell_GCTATGAGGTCG	example/reads_split/cell_GCTATGAGGTCG.umi.txt	example/reads_split/cell_GCTATGAGGTCG_reads.fastq.gz
cell_TTTAATAGCTTT	example/reads_split/cell_TTTAATAGCTTT.umi.txt	example/reads_split/cell_TTTAATAGCTTT_reads.fastq.gz
cell_CAGTCAATGGCG	example/reads_split/cell_CAGTCAATGGCG.umi.txt	example/reads_split/cell_CAGTCAATGGCG_reads.fastq.gz
cell_TCACGCAGCTAC	example/reads_split/cell_TCACGCAGCTAC.umi.txt	example/reads_split/cell_TCACGCAGCTAC_reads.fastq.gz
cell_ATCCGGCTCGAC	example/reads_split/cell_ATCCGGCTCGAC.umi.txt	example/reads_split/cell_ATCCGGCTCGAC_reads.fastq.gz
cell_CCCGATGCAGCC	example/reads_split/cell_CCCGATGCAGCC.umi.txt	example/reads_split/cell_CCCGATGCAGCC_reads.fastq.gz
cell_CCTGTGGCTGGT	example/reads_split/cell_CCTGTGGCTGGT.umi.txt	example/reads_split/cell_CCTGTGGCTGGT_reads.fastq.gz
cell_TATGATGCTACT	example/reads_split/cell_TATGATGCTACT.umi.txt	example/reads_split/cell_TATGATGCTACT_reads.fastq.gz
cell_AGGCGTAGTTCC	example/reads_split/cell_AGGCGTAGTTCC.umi.txt	example/reads_split/cell_AGGCGTAGTTCC_reads.fastq.gz
cell_AATAGGTTGCGC	example/reads_split/cell_AATAGGTTGCGC.umi.txt	example/reads_split/cell_AATAGGTTGCGC_reads.fastq.gz
cell_TAAAGACCACGC	example/reads_split/cell_TAAAGACCACGC.umi.txt	example/reads_split/cell_TAAAGACCACGC_reads.fastq.gz
cell_CAATTTCGGAAA	example/reads_split/cell_CAATTTCGGAAA.umi.txt	example/reads_split/cell_CAATTTCGGAAA_reads.fastq.gz
cell_CGCACCTCGGAA	example/reads_split/cell_CGCACCTCGGAA.umi.txt	example/reads_split/cell_CGCACCTCGGAA_reads.fastq.gz
cell_AGTATTTCGCCA	example/reads_split/cell_AGTATTTCGCCA.umi.txt	example/reads_split/cell_AGTATTTCGCCA_reads.fastq.gz
cell_TAGCATCCCACA	example/reads_split/cell_TAGCATCCCACA.umi.txt	example/reads_split/cell_TAGCATCCCACA_reads.fastq.gz
cell_ATAACCAGACAA	example/reads_split/cell_ATAACCAGACAA.umi.txt	example/reads_split/cell_ATAACCAGACAA_reads.fastq.gz
cell_CTGAAAGCTACG	example/reads_split/cell_CTGAAAGCTACG.umi.txt	example/reads_split/cell_CTGAAAGCTACG_reads.fastq.gz
cell_AACCCTCTGTCA	example/reads_split/cell_AACCCTCTGTCA.umi.txt	example/reads_split/cell_AACCCTCTGTCA_reads.fastq.gz
cell_ACGCTGTAGGGT	example/reads_split/cell_ACGCTGTAGGGT.umi.txt	example/reads_split/cell_ACGCTGTAGGGT_reads.fastq.gz
cell_GCTTAAGTTTCC	example/reads_split/cell_GCTTAAGTTTCC.umi.txt	example/reads_split/cell_GCTTAAGTTTCC_reads.fastq.gz
cell_TCCACGCGAGTC	example/reads_split/cell_TCCACGCGAGTC.umi.txt	example/reads_split/cell_TCCACGCGAGTC_reads.fastq.gz
cell_GGAATGCTTGTT	example/reads_split/cell_GGAATGCTTGTT.umi.txt	example/reads_split/cell_GGAATGCTTGTT_reads.fastq.gz
cell_CCAGCCGAACGA	example/reads_split/cell_CCAGCCGAACGA.umi.txt	example/reads_split/cell_CCAGCCGAACGA_reads.fastq.gz
cell_CGAACATCCGCA	example/reads_split/cell_CGAACATCCGCA.umi.txt	example/reads_split/cell_CGAACATCCGCA_reads.fastq.gz
cell_AACCACGGGTAC	example/reads_split/cell_AACCACGGGTAC.umi.txt	example/reads_split/cell_AACCACGGGTAC_reads.fastq.gz
cell_TCCTTTCAGTCG	example/reads_split/cell_TCCTTTCAGTCG.umi.txt	example/reads_split/cell_TCCTTTCAGTCG_reads.fastq.gz
cell_TTCGCCTTATCG	example/reads_split/cell_TTCGCCTTATCG.umi.txt	example/reads_split/cell_TTCGCCTTATCG_reads.fastq.gz
cell_TGCTATGAATAA	example/reads_split/cell_TGCTATGAATAA.umi.txt	example/reads_split/cell_TGCTATGAATAA_reads.fastq.gz
cell_CACCCGAGCCTA	example/reads_split/cell_CACCCGAGCCTA.umi.txt	example/reads_split/cell_CACCCGAGCCTA_reads.fastq.gz
cell_CTCAACACGCAT	example/reads_split/cell_CTCAACACGCAT.umi.txt	example/reads_split/cell_CTCAACACGCAT_reads.fastq.gz
cell_TTACTTGACTGT	example/reads_split/cell_TTACTTGACTGT.umi.txt	example/reads_split/cell_TTACTTGACTGT_reads.fastq.gz
cell_ATATAGAAGTTC	example/reads_split/cell_ATATAGAAGTTC.umi.txt	example/reads_split/cell_ATATAGAAGTTC_reads.fastq.gz
cell_GCCAGTATGGAG	example/reads_split/cell_GCCAGTATGGAG.umi.txt	example/reads_split/cell_GCCAGTATGGAG_reads.fastq.gz
cell_GACGTCGGATTT	example/reads_split/cell_GACGTCGGATTT.umi.txt	example/reads_split/cell_GACGTCGGATTT_reads.fastq.gz
cell_ACACCGCGACAA	example/reads_split/cell_ACACCGCGACAA.umi.txt	example/reads_split/cell_ACACCGCGACAA_reads.fastq.gz
cell_TCAAAGCCCTAG	example/reads_split/cell_TCAAAGCCCTAG.umi.txt	example/reads_split/cell_TCAAAGCCCTAG_reads.fastq.gz
cell_GACGGAAGGAGC	example/reads_split/cell_GACGGAAGGAGC.umi.txt	example/reads_split/cell_GACGGAAGGAGC_reads.fastq.gz
cell_AAGTTGCGCGAG	example/reads_split/cell_AAGTTGCGCGAG.umi.txt	example/reads_split/cell_AAGTTGCGCGAG_reads.fastq.gz
cell_AACCGAGAACTG	example/reads_split/cell_AACCGAGAACTG.umi.txt	example/reads_split/cell_AACCGAGAACTG_reads.fastq.gz
cell_ATACAACATTAT	example/reads_split/cell_ATACAACATTAT.umi.txt	example/reads_split/cell_ATACAACATTAT_reads.fastq.gz
cell_CCGCGCTGGCTT	example/reads_split/cell_CCGCGCTGGCTT.umi.txt	example/reads_split/cell_CCGCGCTGGCTT_reads.fastq.gz
cell_GCCTATGACAGT	example/reads_split/cell_GCCTATGACAGT.umi.txt	example/reads_split/cell_GCCTATGACAGT_reads.fastq.gz
cell_CTCGCTGCCTCC	example/reads_split/cell_CTCGCTGCCTCC.umi.txt	example/reads_split/cell_CTCGCTGCCTCC_reads.fastq.gz
cell_AATTGTGGTAGC	example/reads_split/cell_AATTGTGGTAGC.umi.txt	example/reads_split/cell_AATTGTGGTAGC_reads.fastq.gz
cell_CTCTCGGCTGAA	example/reads_split/cell_CTCTCGGCTGAA.umi.txt	example/reads_split/cell_CTCTCGGCTGAA_reads.fastq.gz
cell_AAACCTCATACT	example/reads_split/cell_AAACCTCATACT.umi.txt	example/reads_split/cell_AAACCTCATACT_reads.fastq.gz
cell_TCGCATGCGTCG	example/reads_split/cell_TCGCATGCGTCG.umi.txt	example/reads_split/cell_TCGCATGCGTCG_reads.fastq.gz
cell_TTCCCCCTAGGA	example/reads_split/cell_TTCCCCCTAGGA.umi.txt	example/reads_split/cell_TTCCCCCTAGGA_reads.fastq.gz
cell_GCATGAAAACGG	example/reads_split/cell_GCATGAAAACGG.umi.txt	example/reads_split/cell_GCATGAAAACGG_reads.fastq.gz
cell_ACCACGAACGAC	example/reads_split/cell_ACCACGAACGAC.umi.txt	example/reads_split/cell_ACCACGAACGAC_reads.fastq.gz
cell_TATATTATAGAA	example/reads_split/cell_TATATTATAGAA.umi.txt	example/reads_split/cell_TATATTATAGAA_reads.fastq.gz
cell_TTCTTATCGTCA	example/reads_split/cell_TTCTTATCGTCA.umi.txt	example/reads_split/cell_TTCTTATCGTCA_reads.fastq.gz
cell_CTGGCTAGTCGC	example/reads_split/cell_CTGGCTAGTCGC.umi.txt	example/reads_split/cell_CTGGCTAGTCGC_reads.fastq.gz
cell_AGCGGAGCTTTA	example/reads_split/cell_AGCGGAGCTTTA.umi.txt	example/reads_split/cell_AGCGGAGCTTTA_reads.fastq.gz
cell_AAGCCCTTTTGG	example/reads_split/cell_AAGCCCTTTTGG.umi.txt	example/reads_split/cell_AAGCCCTTTTGG_reads.fastq.gz
cell_TCCAGCAGACGT	example/reads_split/cell_TCCAGCAGACGT.umi.txt	example/reads_split/cell_TCCAGCAGACGT_reads.fastq.gz
cell_CACTGGAACCCT	example/reads_split/cell_CACTGGAACCCT.umi.txt	example/reads_split/cell_CACTGGAACCCT_reads.fastq.gz
cell_ATAAGTGTCGGA	example/reads_split/cell_ATAAGTGTCGGA.umi.txt	example/reads_split/cell_ATAAGTGTCGGA_reads.fastq.gz
cell_CCTGATGACGAA	example/reads_split/cell_CCTGATGACGAA.umi.txt	example/reads_split/cell_CCTGATGACGAA_reads.fastq.gz
cell_TTCGAAACCATG	example/reads_split/cell_TTCGAAACCATG.umi.txt	example/reads_split/cell_TTCGAAACCATG_reads.fastq.gz
cell_CATCTACCTGCG	example/reads_split/cell_CATCTACCTGCG.umi.txt	example/reads_split/cell_CATCTACCTGCG_reads.fastq.gz
cell_GCAGTGGGAACA	example/reads_split/cell_GCAGTGGGAACA.umi.txt	example/reads_split/cell_GCAGTGGGAACA_reads.fastq.gz
cell_CTTCGTTAGGTT	example/reads_split/cell_CTTCGTTAGGTT.umi.txt	example/reads_split/cell_CTTCGTTAGGTT_reads.fastq.gz
cell_AACCGTCCACCT	example/reads_split/cell_AACCGTCCACCT.umi.txt	example/reads_split/cell_AACCGTCCACCT_reads.fastq.gz
cell_TGTCATTCGTAC	example/reads_split/cell_TGTCATTCGTAC.umi.txt	example/reads_split/cell_TGTCATTCGTAC_reads.fastq.gz
cell_GAAGCCCGGTGT	example/reads_split/cell_GAAGCCCGGTGT.umi.txt	example/reads_split/cell_GAAGCCCGGTGT_reads.fastq.gz
cell_AGTCACACCAAA	example/reads_split/cell_AGTCACACCAAA.umi.txt	example/reads_split/cell_AGTCACACCAAA_reads.fastq.gz
cell_TGTCCTGAGCCA	example/reads_split/cell_TGTCCTGAGCCA.umi.txt	example/reads_split/cell_TGTCCTGAGCCA_reads.fastq.gz
cell_CCAGACTTCGGG	example/reads_split/cell_CCAGACTTCGGG.umi.txt	example/reads_split/cell_CCAGACTTCGGG_reads.fastq.gz
cell_GTGGCGCACGCT	example/reads_split/cell_GTGGCGCACGCT.umi.txt	example/reads_split/cell_GTGGCGCACGCT_reads.fastq.gz
cell_GCACTACTAACT	example/reads_split/cell_GCACTACTAACT.umi.txt	example/reads_split/cell_GCACTACTAACT_reads.fastq.gz
cell_CTCGTAATGATG	example/reads_split/cell_CTCGTAATGATG.umi.txt	example/reads_split/cell_CTCGTAATGATG_reads.fastq.gz
cell_GGTAACGTTCTG	example/reads_split/cell_GGTAACGTTCTG.umi.txt	example/reads_split/cell_GGTAACGTTCTG_reads.fastq.gz
cell_GGGACACTTCTC	example/reads_split/cell_GGGACACTTCTC.umi.txt	example/reads_split/cell_GGGACACTTCTC_reads.fastq.gz
cell_GCCCGCACTACC	example/reads_split/cell_GCCCGCACTACC.umi.txt	example/reads_split/cell_GCCCGCACTACC_reads.fastq.gz
cell_GTTCTCGTACAA	example/reads_split/cell_GTTCTCGTACAA.umi.txt	example/reads_split/cell_GTTCTCGTACAA_reads.fastq.gz
cell_AACAGCGAATGA	example/reads_split/cell_AACAGCGAATGA.umi.txt	example/reads_split/cell_AACAGCGAATGA_reads.fastq.gz
cell_ATAAGGTATCTT	example/reads_split/cell_ATAAGGTATCTT.umi.txt	example/reads_split/cell_ATAAGGTATCTT_reads.fastq.gz
cell_TTCGCGTGAACA	example/reads_split/cell_TTCGCGTGAACA.umi.txt	example/reads_split/cell_TTCGCGTGAACA_reads.fastq.gz
cell_TCCTTTTGTATA	example/reads_split/cell_TCCTTTTGTATA.umi.txt	example/reads_split/cell_TCCTTTTGTATA_reads.fastq.gz
cell_GGGCAGAAAGGA	example/reads_split/cell_GGGCAGAAAGGA.umi.txt	example/reads_split/cell_GGGCAGAAAGGA_reads.fastq.gz
cell_ACCACGTTTGCG	example/reads_split/cell_ACCACGTTTGCG.umi.txt	example/reads_split/cell_ACCACGTTTGCG_reads.fastq.gz
cell_CGTTTTACCTTG	example/reads_split/cell_CGTTTTACCTTG.umi.txt	example/reads_split/cell_CGTTTTACCTTG_reads.fastq.gz
cell_CACACCTGATGT	example/reads_split/cell_CACACCTGATGT.umi.txt	example/reads_split/cell_CACACCTGATGT_reads.fastq.gz
cell_TTTGGTAGCAAT	example/reads_split/cell_TTTGGTAGCAAT.umi.txt	example/reads_split/cell_TTTGGTAGCAAT_reads.fastq.gz
cell_TCAGCTCTTATT	example/reads_split/cell_TCAGCTCTTATT.umi.txt	example/reads_split/cell_TCAGCTCTTATT_reads.fastq.gz
cell_ACGATGCTGTCT	example/reads_split/cell_ACGATGCTGTCT.umi.txt	example/reads_split/cell_ACGATGCTGTCT_reads.fastq.gz
cell_GAATGATGGTTT	example/reads_split/cell_GAATGATGGTTT.umi.txt	example/reads_split/cell_GAATGATGGTTT_reads.fastq.gz
cell_TGCGTAAGTTGC	example/reads_split/cell_TGCGTAAGTTGC.umi.txt	example/reads_split/cell_TGCGTAAGTTGC_reads.fastq.gz
cell_TTCCGCACTCAA	example/reads_split/cell_TTCCGCACTCAA.umi.txt	example/reads_split/cell_TTCCGCACTCAA_reads.fastq.gz
cell_AAAATGCTCACT	example/reads_split/cell_AAAATGCTCACT.umi.txt	example/reads_split/cell_AAAATGCTCACT_reads.fastq.gz
cell_CTGCAGCTAGAA	example/reads_split/cell_CTGCAGCTAGAA.umi.txt	example/reads_split/cell_CTGCAGCTAGAA_reads.fastq.gz
cell_AATCTGCTTTTC	example/reads_split/cell_AATCTGCTTTTC.umi.txt	example/reads_split/cell_AATCTGCTTTTC_reads.fastq.gz
cell_GGTTATCAAATT	example/reads_split/cell_GGTTATCAAATT.umi.txt	example/reads_split/cell_GGTTATCAAATT_reads.fastq.gz
cell_CCGTCAGCTCTA	example/reads_split/cell_CCGTCAGCTCTA.umi.txt	example/reads_split/cell_CCGTCAGCTCTA_reads.fastq.gz
cell_AATTGCTTCTCA	example/reads_split/cell_AATTGCTTCTCA.umi.txt	example/reads_split/cell_AATTGCTTCTCA_reads.fastq.gz
cell_GGAGGTGCCCTT	example/reads_split/cell_GGAGGTGCCCTT.umi.txt	example/reads_split/cell_GGAGGTGCCCTT_reads.fastq.gz
cell_GTCTGAGCACAT	example/reads_split/cell_GTCTGAGCACAT.umi.txt	example/reads_split/cell_GTCTGAGCACAT_reads.fastq.gz
cell_ATCCCTTTGAGC	example/reads_split/cell_ATCCCTTTGAGC.umi.txt	example/reads_split/cell_ATCCCTTTGAGC_reads.fastq.gz
cell_CAACAGCCCCTC	example/reads_split/cell_CAACAGCCCCTC.umi.txt	example/reads_split/cell_CAACAGCCCCTC_reads.fastq.gz
cell_TGCTGTTCTCGT	example/reads_split/cell_TGCTGTTCTCGT.umi.txt	example/reads_split/cell_TGCTGTTCTCGT_reads.fastq.gz
cell_TGACTATACTCG	example/reads_split/cell_TGACTATACTCG.umi.txt	example/reads_split/cell_TGACTATACTCG_reads.fastq.gz
cell_TCAATTAGAGGG	example/reads_split/cell_TCAATTAGAGGG.umi.txt	example/reads_split/cell_TCAATTAGAGGG_reads.fastq.gz
cell_GGAGATAATGGT	example/reads_split/cell_GGAGATAATGGT.umi.txt	example/reads_split/cell_GGAGATAATGGT_reads.fastq.gz
cell_TATAACATTGGC	example/reads_split/cell_TATAACATTGGC.umi.txt	example/reads_split/cell_TATAACATTGGC_reads.fastq.gz
cell_ACAATCGTAGAA	example/reads_split/cell_ACAATCGTAGAA.umi.txt	example/reads_split/cell_ACAATCGTAGAA_reads.fastq.gz
cell_TAAAGAGAGAGA	example/reads_split/cell_TAAAGAGAGAGA.umi.txt	example/reads_split/cell_TAAAGAGAGAGA_reads.fastq.gz
cell_AGGTTAAGCACT	example/reads_split/cell_AGGTTAAGCACT.umi.txt	example/reads_split/cell_AGGTTAAGCACT_reads.fastq.gz
cell_GAGCTCCTCCCA	example/reads_split/cell_GAGCTCCTCCCA.umi.txt	example/reads_split/cell_GAGCTCCTCCCA_reads.fastq.gz
cell_TTGGTCGACGTT	example/reads_split/cell_TTGGTCGACGTT.umi.txt	example/reads_split/cell_TTGGTCGACGTT_reads.fastq.gz
cell_CCGTTCTACCGG	example/reads_split/cell_CCGTTCTACCGG.umi.txt	example/reads_split/cell_CCGTTCTACCGG_reads.fastq.gz
cell_TTAAGCGGCTTT	example/reads_split/cell_TTAAGCGGCTTT.umi.txt	example/reads_split/cell_TTAAGCGGCTTT_reads.fastq.gz
cell_AGACGCGTCGGG	example/reads_split/cell_AGACGCGTCGGG.umi.txt	example/reads_split/cell_AGACGCGTCGGG_reads.fastq.gz
cell_CTTGGTTTTCTA	example/reads_split/cell_CTTGGTTTTCTA.umi.txt	example/reads_split/cell_CTTGGTTTTCTA_reads.fastq.gz
cell_ATCCCTGCCGTC	example/reads_split/cell_ATCCCTGCCGTC.umi.txt	example/reads_split/cell_ATCCCTGCCGTC_reads.fastq.gz
cell_CTCCGGAATAAC	example/reads_split/cell_CTCCGGAATAAC.umi.txt	example/reads_split/cell_CTCCGGAATAAC_reads.fastq.gz
cell_GTGGAATCACTC	example/reads_split/cell_GTGGAATCACTC.umi.txt	example/reads_split/cell_GTGGAATCACTC_reads.fastq.gz
cell_GGGTGGTAACGA	example/reads_split/cell_GGGTGGTAACGA.umi.txt	example/reads_split/cell_GGGTGGTAACGA_reads.fastq.gz
cell_ACGGCACGCGCT	example/reads_split/cell_ACGGCACGCGCT.umi.txt	example/reads_split/cell_ACGGCACGCGCT_reads.fastq.gz
cell_AAGGTATATGGC	example/reads_split/cell_AAGGTATATGGC.umi.txt	example/reads_split/cell_AAGGTATATGGC_reads.fastq.gz
cell_CAGCCCAGAGAG	example/reads_split/cell_CAGCCCAGAGAG.umi.txt	example/reads_split/cell_CAGCCCAGAGAG_reads.fastq.gz
cell_GCTTAGAGAGAA	example/reads_split/cell_GCTTAGAGAGAA.umi.txt	example/reads_split/cell_GCTTAGAGAGAA_reads.fastq.gz
cell_CCTTGATTCACT	example/reads_split/cell_CCTTGATTCACT.umi.txt	example/reads_split/cell_CCTTGATTCACT_reads.fastq.gz
cell_ACTGAATTCTTG	example/reads_split/cell_ACTGAATTCTTG.umi.txt	example/reads_split/cell_ACTGAATTCTTG_reads.fastq.gz
cell_GAGTTTAATCTC	example/reads_split/cell_GAGTTTAATCTC.umi.txt	example/reads_split/cell_GAGTTTAATCTC_reads.fastq.gz
cell_CCAGTTTCCATC	example/reads_split/cell_CCAGTTTCCATC.umi.txt	example/reads_split/cell_CCAGTTTCCATC_reads.fastq.gz
cell_AGGGAGTACATG	example/reads_split/cell_AGGGAGTACATG.umi.txt	example/reads_split/cell_AGGGAGTACATG_reads.fastq.gz
cell_GGAGTTGCGGGG	example/reads_split/cell_GGAGTTGCGGGG.umi.txt	example/reads_split/cell_GGAGTTGCGGGG_reads.fastq.gz
cell_CACGATTGTTAG	example/reads_split/cell_CACGATTGTTAG.umi.txt	example/reads_split/cell_CACGATTGTTAG_reads.fastq.gz
cell_GTCTCGTGCACC	example/reads_split/cell_GTCTCGTGCACC.umi.txt	example/reads_split/cell_GTCTCGTGCACC_reads.fastq.gz
cell_AGTTCCATCCGC	example/reads_split/cell_AGTTCCATCCGC.umi.txt	example/reads_split/cell_AGTTCCATCCGC_reads.fastq.gz
cell_TGCGTAGATATG	example/reads_split/cell_TGCGTAGATATG.umi.txt	example/reads_split/cell_TGCGTAGATATG_reads.fastq.gz
cell_AATTGGAAGATT	example/reads_split/cell_AATTGGAAGATT.umi.txt	example/reads_split/cell_AATTGGAAGATT_reads.fastq.gz
cell_TCCCAAATATTT	example/reads_split/cell_TCCCAAATATTT.umi.txt	example/reads_split/cell_TCCCAAATATTT_reads.fastq.gz
cell_AACCTGTAGGTG	example/reads_split/cell_AACCTGTAGGTG.umi.txt	example/reads_split/cell_AACCTGTAGGTG_reads.fastq.gz
cell_TTTCCGAACTCA	example/reads_split/cell_TTTCCGAACTCA.umi.txt	example/reads_split/cell_TTTCCGAACTCA_reads.fastq.gz
cell_TATTTGTTACTG	example/reads_split/cell_TATTTGTTACTG.umi.txt	example/reads_split/cell_TATTTGTTACTG_reads.fastq.gz
cell_TACGGCGTCACT	example/reads_split/cell_TACGGCGTCACT.umi.txt	example/reads_split/cell_TACGGCGTCACT_reads.fastq.gz
cell_CAAATTCATCCT	example/reads_split/cell_CAAATTCATCCT.umi.txt	example/reads_split/cell_CAAATTCATCCT_reads.fastq.gz
cell_ACCGGCCCCGGT	example/reads_split/cell_ACCGGCCCCGGT.umi.txt	example/reads_split/cell_ACCGGCCCCGGT_reads.fastq.gz
cell_CGTACTGACTAC	example/reads_split/cell_CGTACTGACTAC.umi.txt	example/reads_split/cell_CGTACTGACTAC_reads.fastq.gz
cell_GGGCTCGATGCG	example/reads_split/cell_GGGCTCGATGCG.umi.txt	example/reads_split/cell_GGGCTCGATGCG_reads.fastq.gz
cell_AGAGTTGTTCGG	example/reads_split/cell_AGAGTTGTTCGG.umi.txt	example/reads_split/cell_AGAGTTGTTCGG_reads.fastq.gz
cell_TGACTAGGTGGG	example/reads_split/cell_TGACTAGGTGGG.umi.txt	example/reads_split/cell_TGACTAGGTGGG_reads.fastq.gz
cell_GACGCACCTGAG	example/reads_split/cell_GACGCACCTGAG.umi.txt	example/reads_split/cell_GACGCACCTGAG_reads.fastq.gz
cell_GGCCCGATTGCA	example/reads_split/cell_GGCCCGATTGCA.umi.txt	example/reads_split/cell_GGCCCGATTGCA_reads.fastq.gz
cell_AGACCAACTCAA	example/reads_split/cell_AGACCAACTCAA.umi.txt	example/reads_split/cell_AGACCAACTCAA_reads.fastq.gz
cell_AACTGGCTAAAC	example/reads_split/cell_AACTGGCTAAAC.umi.txt	example/reads_split/cell_AACTGGCTAAAC_reads.fastq.gz
cell_TCAAGGTCCTTC	example/reads_split/cell_TCAAGGTCCTTC.umi.txt	example/reads_split/cell_TCAAGGTCCTTC_reads.fastq.gz
cell_CAATGGATGTGC	example/reads_split/cell_CAATGGATGTGC.umi.txt	example/reads_split/cell_CAATGGATGTGC_reads.fastq.gz
cell_TGGGACTACGGG	example/reads_split/cell_TGGGACTACGGG.umi.txt	example/reads_split/cell_TGGGACTACGGG_reads.fastq.gz
cell_TCCCACGCTGAA	example/reads_split/cell_TCCCACGCTGAA.umi.txt	example/reads_split/cell_TCCCACGCTGAA_reads.fastq.gz
cell_GTACGAATACCT	example/reads_split/cell_GTACGAATACCT.umi.txt	example/reads_split/cell_GTACGAATACCT_reads.fastq.gz
cell_AGAGCATAGCGC	example/reads_split/cell_AGAGCATAGCGC.umi.txt	example/reads_split/cell_AGAGCATAGCGC_reads.fastq.gz
cell_CCTGTCTCTTAT	example/reads_split/cell_CCTGTCTCTTAT.umi.txt	example/reads_split/cell_CCTGTCTCTTAT_reads.fastq.gz
cell_TGGTTCGAGTGC	example/reads_split/cell_TGGTTCGAGTGC.umi.txt	example/reads_split/cell_TGGTTCGAGTGC_reads.fastq.gz
cell_ATCCTAGCCTGT	example/reads_split/cell_ATCCTAGCCTGT.umi.txt	example/reads_split/cell_ATCCTAGCCTGT_reads.fastq.gz
cell_AACCCGGGACCG	example/reads_split/cell_AACCCGGGACCG.umi.txt	example/reads_split/cell_AACCCGGGACCG_reads.fastq.gz
cell_TCTCTCCCCTTG	example/reads_split/cell_TCTCTCCCCTTG.umi.txt	example/reads_split/cell_TCTCTCCCCTTG_reads.fastq.gz
cell_TCGCGAGAAAAT	example/reads_split/cell_TCGCGAGAAAAT.umi.txt	example/reads_split/cell_TCGCGAGAAAAT_reads.fastq.gz
